	manual_annotation
AAACAGCCAAGGCCAA-1	Neural_Anterior
AAACAGCCAATATAGG-1	Somites
AAACAGCCACCTAATG-1	Neural_Anterior
AAACAGCCAGCATGAG-1	Neural_Posterior
AAACAGCCATTGACAT-1	Neural_Posterior
AAACATGCAAATACCT-1	Neural_Anterior
AAACATGCAGTTATCG-1	Neural_Posterior
AAACCAACAAACCCTA-1	Somites
AAACCAACAGCACGTT-1	Neural_Anterior
AAACCGAAGAGCAAGC-1	Neural_Anterior
AAACCGAAGTGTGATC-1	Neural_Posterior
AAACCGCGTTCGGGAT-1	Neural_Anterior
AAACCGGCAAAGGTAC-1	Neural_Posterior
AAACGCGCAATGCGCT-1	Neural_Posterior
AAACGCGCATCATGTG-1	Neural_Posterior
AAACGCGCATGGAGGC-1	Neural_Posterior
AAACGGATCCTGATGG-1	Neural_Posterior
AAACGGATCGCTAGCA-1	Neural_Posterior
AAACGTACAATCCTGA-1	Somites
AAACGTACAGCAAGGC-1	Neural_Anterior
AAACGTACAGTCTAGC-1	Neural_Anterior
AAACGTACATCAATCG-1	Neural_Anterior
AAACGTACATCAGTAT-1	Neural_Posterior
AAACGTACATCCCGCT-1	Neural_Posterior
AAAGCAAGTACCGTAA-1	Neural_Anterior
AAAGCAAGTACGTTTC-1	Neural_Anterior
AAAGCAAGTCGTTATC-1	Neural_Anterior
AAAGCACCAAACTGCC-1	Somites
AAAGCACCAATAGCAA-1	Neural_Anterior
AAAGCACCAATGCGCT-1	Neural_Anterior
AAAGCACCACCTGCTC-1	Neural_Posterior
AAAGCACCAGCACCAT-1	Neural_Anterior
AAAGCACCAGTAGCCT-1	Neural_Posterior
AAAGCACCATTATGCG-1	Neural_Posterior
AAAGCCCGTCTTACTA-1	Neural_Anterior
AAAGCCCGTTCGCTCA-1	Neural_Anterior
AAAGCCGCAAGTGTCC-1	Neural_Anterior
AAAGCTTGTCCGCTGT-1	Neural_Anterior
AAAGGACGTGAACAAA-1	Neural_Anterior
AAAGGACGTTTCGCGC-1	Neural_Anterior
AAAGGACGTTTGAGGC-1	Neural_Posterior
AAAGGCTCACCTCACC-1	Neural_Posterior
AAAGGCTCATAGACTT-1	Neural_Posterior
AAAGGTTAGCACCACA-1	Neural_Posterior
AAAGGTTAGCCAGGTC-1	Neural_Anterior
AAAGGTTAGGTTACAC-1	Neural_Anterior
AAATCCGGTTAGGACC-1	Neural_Anterior
AAATCCGGTTGGGTTA-1	Neural_Posterior
AAATGCCTCCTAAGAC-1	Neural_Anterior
AAATGGCCAAATTCGT-1	Somites
AAATGGCCAAGGATTA-1	Neural_Anterior
AAATGGCCAATCCCTT-1	Neural_Posterior
AAATGGCCACTAAGTT-1	Neural_Posterior
AAATGGCCAGTTTACG-1	Neural_Anterior
AACAAAGGTTTCCACG-1	Neural_Anterior
AACAAGCCAATGAAGC-1	Neural_Posterior
AACAAGCCAATTAAGG-1	Neural_Posterior
AACAAGCCATAAGCAA-1	Neural_Anterior
AACAGATAGCAAGGGT-1	Neural_Posterior
AACAGATAGCATGACT-1	Neural_Anterior
AACAGCAAGATGGACA-1	Neural_Anterior
AACAGCAAGCCTGGTA-1	Neural_Anterior
AACAGCAAGTGAGAGC-1	Neural_Anterior
AACAGGATCCTTGCAC-1	Neural_Posterior
AACATAGCACAACCTA-1	Neural_Posterior
AACATAGCAGATAGAC-1	Neural_Anterior
AACATAGCAGGTCCTG-1	Neural_Anterior
AACATAGCATAATGAG-1	Neural_Posterior
AACATCATCATTACTC-1	Neural_Posterior
AACATCATCCTTGCAC-1	Neural_Posterior
AACATCATCTAATTGG-1	Neural_Anterior
AACATTGTCAGTGAAG-1	Neural_Anterior
AACATTGTCGTTAGTA-1	Neural_Anterior
AACATTGTCTCAATTC-1	Neural_Posterior
AACCCGCAGGATTTGC-1	Neural_Anterior
AACCCGCAGGGCCACT-1	Neural_Posterior
AACCCGCAGGTCATTA-1	Neural_Anterior
AACCTAATCACACAGT-1	Neural_Posterior
AACCTAATCCAATAGC-1	Neural_Posterior
AACCTAATCCAGGTCA-1	Neural_Anterior
AACCTAATCCCTGTTA-1	Neural_Anterior
AACCTAATCTTACTCG-1	Neural_Posterior
AACCTCACATGAGCAG-1	Neural_Anterior
AACCTCCTCAGGGCCT-1	Neural_Posterior
AACCTCCTCGCTATGG-1	Neural_Posterior
AACCTCCTCGTTTCCA-1	Neural_Posterior
AACCTCCTCTCATCAT-1	Neural_Posterior
AACCTTAAGCGAAGTA-1	Neural_Anterior
AACCTTAAGGGCCATC-1	Neural_Posterior
AACCTTAAGGTTTGAC-1	Neural_Anterior
AACCTTAAGTAAGAAC-1	Neural_Anterior
AACCTTAAGTCATTGA-1	Neural_Posterior
AACCTTGCACGGTTTA-1	Neural_Anterior
AACCTTGCAGCAAGTG-1	Neural_Posterior
AACCTTGCATAAGTCT-1	unassigned
AACGACAAGCTGGCTA-1	Neural_Posterior
AACGACAAGGCAAGTA-1	Neural_Anterior
AACGCCCAGAAAGGAA-1	Neural_Posterior
AACGCCCAGGCTCATG-1	Neural_Posterior
AACGCCCAGGTCATTA-1	Neural_Anterior
AACGCTAGTAAGCACC-1	Neural_Posterior
AACTACTCATTAGGCC-1	Neural_Posterior
AACTACTCATTTGCTC-1	Neural_Anterior
AACTAGCTCACCATTT-1	Neural_Posterior
AACTAGCTCAGCATTA-1	Neural_Anterior
AACTAGCTCCGTCCAT-1	Neural_Anterior
AACTAGCTCCTCCATA-1	Neural_Anterior
AACTAGCTCCTGATGG-1	Neural_Posterior
AACTAGCTCGTTAAGC-1	Neural_Posterior
AACTAGCTCTCAATTC-1	Neural_Posterior
AACTAGTGTACCGTTT-1	Neural_Anterior
AACTAGTGTTACGCGG-1	Neural_Posterior
AACTCACAGCGCTCAA-1	Neural_Anterior
AACTCACAGGACCTGC-1	Neural_Anterior
AACTCACAGTCTCACC-1	Neural_Anterior
AACTGTTCAATAGTCT-1	Neural_Anterior
AACTGTTCACAAACTT-1	Neural_Posterior
AACTGTTCATGTCAAT-1	Neural_Posterior
AACTTAGTCCCTCAAC-1	Neural_Anterior
AAGAACAGTCCCGAAG-1	Neural_Anterior
AAGAACAGTGACATGC-1	Neural_Posterior
AAGAACAGTTTACGTC-1	Neural_Anterior
AAGAATCAGCACTAAC-1	Neural_Posterior
AAGAATCAGCTTCCCG-1	Neural_Posterior
AAGAATCAGGCTTAAC-1	Neural_Posterior
AAGAATCAGTATTGCA-1	Neural_Anterior
AAGACAAGTGTTGCAA-1	Neural_Posterior
AAGACATAGAGGAAGG-1	Neural_Posterior
AAGACATAGTAAACCC-1	Neural_Posterior
AAGACATAGTACTGGT-1	Neural_Posterior
AAGACCAAGCATGAAG-1	Neural_Anterior
AAGACCAAGGAGTCTT-1	Neural_Anterior
AAGACCAAGGCTCATG-1	Neural_Posterior
AAGACCAAGTAGGCGG-1	Neural_Anterior
AAGACCAAGTGCTGTG-1	Neural_Posterior
AAGCAAGTCCTCGATC-1	Neural_Anterior
AAGCATGAGCAAGACA-1	Neural_Posterior
AAGCATGAGTGAGCAA-1	Neural_Anterior
AAGCCACGTAGGTTGC-1	Neural_Posterior
AAGCCACGTCCACAAA-1	Neural_Posterior
AAGCCACGTTTAACGG-1	Neural_Posterior
AAGCCTCCAAGTGTCC-1	unassigned
AAGCCTCCAATTAACC-1	Neural_Anterior
AAGCCTGTCATGCATA-1	Neural_Anterior
AAGCCTGTCCTACCTA-1	Neural_Anterior
AAGCCTGTCGTTTCCA-1	Neural_Posterior
AAGCCTTAGCATGAAG-1	Neural_Posterior
AAGCCTTAGGTTTACA-1	Neural_Anterior
AAGCGAATCACAGCGC-1	Neural_Posterior
AAGCGAATCCCGTTGT-1	Muscle
AAGCGAGGTAGCTGGT-1	Neural_Posterior
AAGCGAGGTCAGGCCA-1	Neural_Anterior
AAGCGAGGTGCTCACC-1	Neural_Posterior
AAGCGAGGTTAGAGGG-1	Neural_Anterior
AAGCGCTGTAGGTTAT-1	Somites
AAGCGGGTCGGGCCAT-1	Neural_Anterior
AAGCGTTTCAACCAAC-1	Neural_Posterior
AAGCGTTTCAGCACCA-1	Neural_Anterior
AAGCGTTTCGATAACC-1	Neural_Anterior
AAGCTAGAGGCAATAG-1	Neural_Posterior
AAGCTATGTGATTACG-1	Neural_Posterior
AAGCTATGTTAGTTGG-1	Somites
AAGCTCCCAACCGCCA-1	Neural_Anterior
AAGCTCCCAGATAGAC-1	Neural_Anterior
AAGCTCCCATACTCCT-1	Neural_Posterior
AAGCTCCCATAGACTT-1	Neural_Anterior
AAGCTTGGTACGCGCA-1	Neural_Posterior
AAGGAAGCACAGCCAT-1	Neural_Posterior
AAGGATCCAGTAATAG-1	Neural_Posterior
AAGGATGTCCCTGTTA-1	Neural_Anterior
AAGGCCCTCAAATCGC-1	Neural_Posterior
AAGGCCCTCAGTATTG-1	Neural_Anterior
AAGGCCCTCCTTCGTA-1	Neural_Anterior
AAGGTCAAGCTCCCTG-1	Neural_Anterior
AAGGTCAAGCTGCACA-1	Neural_Posterior
AAGGTCAAGTCCTGAG-1	Neural_Posterior
AAGGTGCAGCTATTAG-1	Neural_Anterior
AAGGTGCAGGAACGCG-1	Neural_Anterior
AAGGTGCAGGTGCGGA-1	Neural_Posterior
AAGGTGCAGTTACCGG-1	Neural_Posterior
AAGTAGCCAACAGGAT-1	Neural_Anterior
AAGTAGCCAAGGTCGA-1	Neural_Anterior
AAGTAGCCACAGGAAT-1	Neural_Anterior
AAGTAGCCACTTACAG-1	Neural_Posterior
AAGTAGCCATACCCGG-1	Neural_Anterior
AAGTCTATCATGGCTG-1	Neural_Anterior
AAGTGAAGTATTGCAG-1	Neural_Anterior
AAGTGAAGTCTTGCAT-1	Neural_Anterior
AAGTGAAGTTTGCGCC-1	Neural_Anterior
AAGTGCAAGCCGCTAA-1	Somites
AAGTGCAAGCCTCTGT-1	Neural_Posterior
AAGTGCAAGCTGTACG-1	Neural_Posterior
AAGTGTTGTAGGATTT-1	Neural_Posterior
AAGTGTTGTCATGCCC-1	Neural_Anterior
AAGTGTTGTTAGCGTA-1	Neural_Anterior
AAGTTACGTTCTTTAG-1	Neural_Anterior
AAGTTACGTTGCGCGA-1	Neural_Posterior
AAGTTACGTTGGGTTA-1	Neural_Posterior
AAGTTACGTTTCCTCC-1	Neural_Posterior
AAGTTAGCACAATGTT-1	Neural_Posterior
AAGTTAGCATTAAGTC-1	Muscle
AAGTTTGTCAGGAAGC-1	Neural_Anterior
AAGTTTGTCCGCCTAT-1	Neural_Posterior
AAGTTTGTCGGTTTCC-1	Neural_Posterior
AAGTTTGTCTAGCGTG-1	Neural_Posterior
AATAACCGTGGATTCA-1	Neural_Anterior
AATAACCGTGTCCTGC-1	Somites
AATACCGGTCGTAATG-1	Neural_Anterior
AATACCGGTGTTTCAC-1	Neural_Posterior
AATAGAGGTGCGCATG-1	Neural_Anterior
AATAGCTGTTGGCCGA-1	Neural_Posterior
AATATCCCAACTGGGA-1	Neural_Anterior
AATATCCCACGTAATT-1	Neural_Anterior
AATCAGGAGCATGCAT-1	Neural_Posterior
AATCAGGAGTAAGAAC-1	Neural_Posterior
AATCAGGAGTTAGTTG-1	Neural_Posterior
AATCATGTCCGCTAGA-1	Muscle
AATCATGTCTGTTGCC-1	Neural_Anterior
AATCCATCAAACTAAG-1	Neural_Posterior
AATCCATCAACTAGGG-1	Neural_Posterior
AATCCATCACTCAACA-1	Neural_Anterior
AATCCATCAGTAAAGC-1	Neural_Anterior
AATCCCTGTAACGAGG-1	Neural_Anterior
AATCCCTGTTTGGTTC-1	Neural_Anterior
AATCCGTAGACACCGC-1	Neural_Anterior
AATCCGTAGAGAGCCG-1	Neural_Posterior
AATCCGTAGCCGCTTT-1	Neural_Anterior
AATCCGTAGCTATTAG-1	Neural_Anterior
AATCCGTAGTGTTGCG-1	Neural_Anterior
AATCCTAAGCCAGGTC-1	Neural_Anterior
AATCCTAAGGTTAGCT-1	Neural_Anterior
AATCGCCCAGAAATGC-1	Neural_Anterior
AATCGCCCATAAGTCT-1	Neural_Posterior
AATCTCAAGCTGTAAC-1	Neural_Posterior
AATCTCAAGGACTTAC-1	Neural_Posterior
AATCTCAAGTAAGGGC-1	Neural_Posterior
AATCTCAAGTATTGGC-1	Neural_Posterior
AATCTTGAGCATGTCG-1	Neural_Posterior
AATCTTGAGCGAGGTG-1	Neural_Anterior
AATCTTGAGGGCTAAA-1	Neural_Anterior
AATGAAGGTCACCTAT-1	Neural_Anterior
AATGCAACAACCTGGT-1	Neural_Posterior
AATGCAACAGCAAGTG-1	Neural_Posterior
AATGCAACAGGACACA-1	Neural_Posterior
AATGCAACATAATCCG-1	Neural_Posterior
AATGCAACATTAAGTC-1	Neural_Anterior
AATGCATGTCGCGCAA-1	Neural_Anterior
AATGCATGTCTTTGAC-1	Neural_Anterior
AATGCATGTGGGTGAA-1	Neural_Posterior
AATGCGCGTAATCGTG-1	Neural_Anterior
AATGCGCGTAGTCAAT-1	Neural_Posterior
AATGCGCGTTAGAGGG-1	Neural_Anterior
AATGCGCGTTTCCTCC-1	unassigned
AATGGCGCAATCCTAG-1	Neural_Anterior
AATGGCGCATTATGGT-1	Neural_Anterior
AATGTCATCCGGTATG-1	Neural_Posterior
AATGTCATCGAGGAGT-1	Muscle
AATGTCATCTGTTCAT-1	Neural_Anterior
AATGTCCAGACACCGC-1	Neural_Posterior
AATGTCCAGGGATGAC-1	Neural_Posterior
AATGTCCAGTAACGAG-1	Neural_Posterior
AATGTCCAGTTTGTCT-1	Neural_Posterior
AATTAGCGTATACTGG-1	Neural_Anterior
AATTAGCGTCATTGTC-1	Neural_Anterior
AATTAGCGTGGTTCTT-1	Neural_Posterior
AATTAGCGTTTGCGCC-1	Neural_Anterior
AATTAGGCACCCACAG-1	Neural_Anterior
AATTAGGCAGCATGGA-1	Neural_Anterior
AATTAGGCATCACAGC-1	Neural_Anterior
AATTAGGCATCCTAGA-1	Neural_Anterior
AATTCGTCAGGCCTTG-1	Neural_Anterior
AATTCGTCAGGCTAGA-1	Muscle
AATTCGTCAGTTAGCC-1	Neural_Anterior
AATTGACGTTGGATAT-1	Neural_Posterior
AATTGCCAGCAAGGTA-1	Neural_Anterior
AATTGCCAGGATGATG-1	Neural_Posterior
AATTGCCAGTTAACCA-1	Neural_Anterior
AATTGCTCAGTTTCTC-1	Neural_Anterior
AATTGGACAATTAGCT-1	Neural_Posterior
AATTGGACACAACAAA-1	Neural_Anterior
AATTGGACAGAGGCTA-1	Neural_Anterior
AATTGGACAGCTTAAT-1	Neural_Anterior
AATTGGACATAGCTGC-1	Neural_Anterior
AATTGGGAGCGGGCAA-1	Neural_Anterior
AATTTCCTCCTGCGAA-1	Neural_Anterior
AATTTCCTCCTTGCGT-1	Neural_Posterior
AATTTCCTCTCACTAT-1	Neural_Anterior
AATTTCCTCTCCTCAA-1	Neural_Anterior
AATTTCCTCTTAGTCT-1	Neural_Posterior
AATTTGCCAATCTCTC-1	Neural_Anterior
AATTTGCCAGAAATTG-1	Neural_Posterior
AATTTGCCATTATGAC-1	Neural_Anterior
AATTTGGTCAATGAGG-1	Neural_Anterior
AATTTGGTCACCAATA-1	Neural_Posterior
AATTTGGTCGATAACC-1	Neural_Anterior
AATTTGGTCGTCATTT-1	Somites
ACAAACTGTTAGTACG-1	Neural_Posterior
ACAACAACAACTAGGG-1	Neural_Anterior
ACAACAACACCGTTCC-1	Somites
ACAACAACAGGCATCT-1	Neural_Anterior
ACAACAACAGTAGGTG-1	Neural_Anterior
ACAACAACATAAGTCT-1	Neural_Anterior
ACAACACTCGAAGTAG-1	Neural_Anterior
ACAACAGAGCAAGGTA-1	Neural_Posterior
ACAACAGAGCCGCTTT-1	Neural_Posterior
ACAACAGAGGCTGTGC-1	Neural_Anterior
ACAACAGAGGGCTTTG-1	Neural_Posterior
ACAACAGAGGTGAAAT-1	Neural_Posterior
ACAACATGTAAACAAG-1	Neural_Posterior
ACAACATGTAACGTGC-1	Neural_Posterior
ACAACATGTAATGGCC-1	Neural_Posterior
ACAACATGTAGTTACG-1	Neural_Posterior
ACAACATGTGATTTGG-1	Neural_Posterior
ACAACATGTTACGCAA-1	Neural_Posterior
ACACAATGTCCTCCAA-1	Neural_Posterior
ACACAATGTGTTGCAA-1	Neural_Anterior
ACACAATGTTGCGGAT-1	Neural_Anterior
ACACCTTGTACCGAAC-1	Neural_Posterior
ACACGGACATGCTATG-1	Somites
ACACTAATCCCGTTAC-1	Neural_Posterior
ACACTAATCTTAGGGT-1	Neural_Posterior
ACACTAGGTAACCAGC-1	Neural_Posterior
ACACTAGGTGTTTGTC-1	Neural_Posterior
ACACTTAAGGAGTCTT-1	Neural_Posterior
ACACTTAAGGCGCTAC-1	Neural_Anterior
ACACTTAAGGTGAAGC-1	Neural_Posterior
ACACTTAAGTATGTGC-1	Neural_Anterior
ACACTTAAGTTAGCTA-1	Neural_Anterior
ACACTTGCAAGTCGCT-1	Neural_Posterior
ACACTTGCATGGCCTG-1	Neural_Anterior
ACAGCCGGTCACAAAT-1	Neural_Anterior
ACAGCCGGTCCTAACT-1	Neural_Anterior
ACAGCCGGTGCTTAGA-1	Neural_Anterior
ACAGCCGGTTAAGTGT-1	Neural_Posterior
ACAGCCGGTTCAAGCA-1	Neural_Anterior
ACAGCGCTCAATCTAG-1	Neural_Anterior
ACAGCGCTCAGGGCCT-1	Neural_Posterior
ACAGCGCTCCCTCGCA-1	Neural_Posterior
ACAGGAATCACAAGCT-1	Neural_Anterior
ACAGGAATCATGCTCC-1	Muscle
ACAGGAATCGATCAGT-1	Neural_Posterior
ACAGGATCAAGCCACT-1	Neural_Posterior
ACAGGATCAAGCTTAT-1	Neural_Posterior
ACAGGATCACGCAACT-1	Neural_Posterior
ACAGGATCACTGGCTG-1	Neural_Posterior
ACAGGATCAGCTTAGC-1	Neural_Posterior
ACAGGCTGTAACGGGA-1	Neural_Anterior
ACAGGCTGTAATTAGC-1	Neural_Anterior
ACAGGCTGTGATTTGG-1	Neural_Posterior
ACAGGCTGTGCTTAGA-1	Neural_Anterior
ACAGGCTGTTAAGGCC-1	Neural_Posterior
ACAGGCTGTTCCAGGG-1	Muscle
ACAGGTAAGCCTGATG-1	NMPs
ACAGGTAAGGATTTGC-1	Muscle
ACAGGTAAGGCCTAAT-1	Neural_Anterior
ACAGGTAAGGCGAATA-1	Neural_Posterior
ACAGGTAAGGCTGTGC-1	Muscle
ACAGGTAAGGGTTAGA-1	Neural_Anterior
ACAGGTAAGGTTACGT-1	unassigned
ACAGGTAAGTGAACAG-1	Neural_Posterior
ACAGTATGTCAACAAT-1	Neural_Anterior
ACAGTATGTGCTGTAA-1	Neural_Posterior
ACATAGCTCAGGGCCT-1	Neural_Posterior
ACATAGCTCCCTGATC-1	Neural_Anterior
ACATAGCTCGCGACAC-1	Muscle
ACATAGCTCGCTCACT-1	Neural_Posterior
ACATAGCTCGGCTAGC-1	Neural_Posterior
ACATCAATCATGTCAA-1	NMPs
ACATCAATCCTGCGAA-1	Neural_Anterior
ACATCATCAAAGCGGC-1	Neural_Anterior
ACATCATCATAATCGT-1	unassigned
ACATCATCATTTAAGC-1	Neural_Posterior
ACATTAGTCCGCCTAT-1	Neural_Anterior
ACATTAGTCCTAACGG-1	Neural_Anterior
ACATTAGTCGTCATTT-1	Neural_Posterior
ACATTGCAGAGAGGCT-1	Neural_Anterior
ACATTGCAGCTTTGTT-1	Neural_Anterior
ACATTGCAGGACTTAC-1	Neural_Posterior
ACATTGCAGGGTCTAT-1	Neural_Anterior
ACCAAACTCGGGACTC-1	Neural_Anterior
ACCAAACTCTAATTGG-1	Neural_Anterior
ACCAAGCGTAGTTGGC-1	Neural_Anterior
ACCAAGCGTATCTGGA-1	Neural_Anterior
ACCAAGCGTATTCGTC-1	Neural_Anterior
ACCAAGCGTCAATACG-1	Neural_Anterior
ACCAAGCGTCACCTAT-1	Neural_Anterior
ACCAAGCGTTGTTGGA-1	Neural_Anterior
ACCAAGTTCATAACCA-1	Neural_Anterior
ACCAAGTTCATAGACC-1	Neural_Anterior
ACCAAGTTCGCGCTAA-1	Neural_Anterior
ACCAAGTTCGTGCTAG-1	Neural_Anterior
ACCAAGTTCTTAGTCT-1	Neural_Posterior
ACCAAGTTCTTGAGGT-1	Neural_Posterior
ACCAATATCTTAATGG-1	Neural_Anterior
ACCACACCAAGCTACC-1	Neural_Posterior
ACCACACCACGTAAGG-1	Somites
ACCACACCATTCCTCG-1	Neural_Posterior
ACCACATAGATTGAGG-1	Somites
ACCACATAGCACTAAC-1	Neural_Anterior
ACCAGCTCAATTGAGA-1	Neural_Posterior
ACCAGCTCAGTAGGTG-1	Neural_Anterior
ACCAGCTCATGAATAG-1	Neural_Anterior
ACCAGCTCATTAAGCT-1	Neural_Posterior
ACCAGGACAATGAAGC-1	Neural_Anterior
ACCAGGACACTAAGCC-1	Neural_Posterior
ACCAGGACAGGAATCG-1	Neural_Anterior
ACCAGGACATCACAGC-1	Neural_Posterior
ACCAGGACATGAAGTA-1	Neural_Anterior
ACCAGGCTCACAGACT-1	Neural_Anterior
ACCAGGCTCGCTCACT-1	Neural_Posterior
ACCAGGCTCTTTAGGA-1	Neural_Posterior
ACCAGGGAGAGGAAGG-1	Neural_Anterior
ACCAGGGAGCTTTGTT-1	Neural_Anterior
ACCAGGGAGGAACGCG-1	Neural_Posterior
ACCAGGGAGGGCTTAT-1	Neural_Anterior
ACCATAATCCGCCTCA-1	Neural_Anterior
ACCATAATCGCTATGG-1	Neural_Anterior
ACCATTAAGACTTATG-1	Neural_Anterior
ACCATTAAGCATGTCG-1	Neural_Anterior
ACCATTAAGCGAAGTA-1	Neural_Anterior
ACCATTAAGGCCTTAG-1	Neural_Anterior
ACCATTAAGGTTTACA-1	Muscle
ACCATTAAGTGAAGTG-1	Neural_Anterior
ACCATTAAGTGGCGGA-1	Neural_Anterior
ACCCAACCACATACTG-1	Neural_Anterior
ACCCAACCAGATTCAT-1	Neural_Anterior
ACCCAGGGTACGATTG-1	Neural_Anterior
ACCCAGGGTACGGGTT-1	Neural_Posterior
ACCCAGGGTTTCCTCC-1	Neural_Posterior
ACCCGCTGTTAGCTGA-1	Neural_Posterior
ACCCGCTGTTCACTGT-1	Neural_Anterior
ACCCGGTAGACTCGCA-1	Neural_Posterior
ACCCGTAAGCCTAACG-1	Muscle
ACCCGTAAGCGCTAAT-1	Neural_Anterior
ACCCGTAAGTCTTGAA-1	Neural_Posterior
ACCCGTAAGTGATTCA-1	Neural_Anterior
ACCCGTAAGTTTCCGC-1	Neural_Anterior
ACCCTCCCACCAGCAT-1	Neural_Anterior
ACCCTCCCACCTGCCT-1	Somites
ACCCTCCCAGTAAGTA-1	Neural_Anterior
ACCCTCCCAGTAGGAT-1	Neural_Anterior
ACCCTGTTCCAATTAG-1	Neural_Anterior
ACCCTGTTCCCATAAA-1	Neural_Anterior
ACCCTGTTCTAGCGAT-1	Neural_Posterior
ACCGAAGCATCACTTC-1	Neural_Anterior
ACCGGCTAGCTATTAG-1	Neural_Anterior
ACCGGCTAGGAACCGG-1	Somites
ACCGGTTCAAAGCTCC-1	Neural_Posterior
ACCGGTTCAAAGGCCA-1	Neural_Anterior
ACCTAAATCACAAGCT-1	Muscle
ACCTAAATCATGAGCT-1	Neural_Anterior
ACCTAAATCGCACAAT-1	Neural_Posterior
ACCTAAATCGTTAAGC-1	Muscle
ACCTAAGGTCTTACTA-1	Neural_Anterior
ACCTAAGGTGAGGTAG-1	Neural_Posterior
ACCTACCTCAATTACG-1	Neural_Anterior
ACCTACCTCCCGAAGC-1	Neural_Posterior
ACCTCACTCAGTGAAG-1	Neural_Anterior
ACCTCACTCCATAATG-1	Neural_Anterior
ACCTCACTCGAGCAAA-1	Neural_Posterior
ACCTGGATCATCCACC-1	Neural_Posterior
ACCTGGATCCATAAGC-1	Neural_Posterior
ACCTGGATCGGGATTT-1	Neural_Anterior
ACCTGGTCAACTAGCC-1	Neural_Anterior
ACCTGGTCAAGTAAGC-1	Neural_Anterior
ACCTGGTCAGCTAATT-1	Neural_Anterior
ACCTGGTCAGTAAGTA-1	Neural_Posterior
ACCTGGTCATAAACCT-1	Somites
ACCTGGTCATAGCGGA-1	Somites
ACCTGTTGTGCCTCAC-1	Neural_Posterior
ACCTTCATCACCGGTA-1	Neural_Posterior
ACCTTCATCAGCCAAT-1	Neural_Posterior
ACCTTCCAGGGACGCA-1	Neural_Anterior
ACCTTCCAGTGAGGGT-1	Neural_Anterior
ACCTTGCTCAGGCTAT-1	Neural_Anterior
ACCTTGCTCATTCATC-1	Neural_Posterior
ACCTTGCTCTTGAGCG-1	Neural_Posterior
ACCTTGTGTCCGGTTC-1	Neural_Posterior
ACCTTGTGTCGCAAAC-1	Neural_Posterior
ACCTTGTGTTTGAGCA-1	Neural_Anterior
ACGAACAAGGTCAAAG-1	Neural_Posterior
ACGAAGTCAAATACCT-1	Neural_Anterior
ACGAATCTCTTCAATC-1	Neural_Posterior
ACGACAAAGCCGGTAC-1	Neural_Anterior
ACGACTTAGACAAACG-1	Neural_Anterior
ACGACTTAGCCGCAAC-1	Neural_Anterior
ACGACTTAGCGTGCAC-1	Neural_Posterior
ACGACTTAGGATCACT-1	Neural_Posterior
ACGACTTAGGCTACAT-1	Neural_Anterior
ACGACTTAGTCTCACC-1	Neural_Posterior
ACGAGTAAGCAATAGG-1	Neural_Posterior
ACGAGTAAGGCCTGGT-1	Neural_Anterior
ACGATTCAGACAGGTA-1	Neural_Anterior
ACGCAAGCAAACAACA-1	Neural_Anterior
ACGCAAGCAGGAATCG-1	Neural_Anterior
ACGCCTAAGCTCCTTA-1	Neural_Anterior
ACGCCTAAGGCGAAAC-1	Neural_Posterior
ACGCCTAAGGTTAGCT-1	Neural_Anterior
ACGCCTAAGTAGCTTA-1	Neural_Anterior
ACGCCTTTCATTACTC-1	Muscle
ACGCCTTTCCATTACT-1	Neural_Anterior
ACGCCTTTCGCATCCT-1	Neural_Anterior
ACGCTTGAGGCTGTGC-1	Neural_Anterior
ACGCTTGAGTCAGTAC-1	Neural_Anterior
ACGCTTGAGTTGTCAA-1	Neural_Anterior
ACGGGAAGTGATCATG-1	Neural_Anterior
ACGGGAAGTGCACGCA-1	Neural_Posterior
ACGGGAAGTGTCCTGC-1	Neural_Anterior
ACGGGAAGTTTCAGGA-1	Neural_Posterior
ACGGTTAGTCATGCCC-1	Neural_Posterior
ACGGTTAGTGTTTGAG-1	Neural_Posterior
ACGGTTAGTTCCAGGG-1	Neural_Anterior
ACGGTTTAGGAACCAA-1	Neural_Posterior
ACGGTTTAGGCATGTT-1	Neural_Anterior
ACGGTTTAGGCCCAGT-1	Neural_Anterior
ACGGTTTAGTCACTCC-1	Neural_Anterior
ACGTACCCACAGACTC-1	Neural_Posterior
ACGTCAAGTGCATCGG-1	NMPs
ACGTCAAGTTCACCCA-1	Neural_Anterior
ACGTCCAAGCTGGAAA-1	Neural_Anterior
ACGTCCAAGTTTAACG-1	Neural_Posterior
ACGTCCAAGTTTGGTA-1	Somites
ACGTCCTTCCTAATTC-1	Neural_Posterior
ACGTCCTTCGGTTAGT-1	Neural_Anterior
ACGTTACAGAATCGCT-1	Neural_Anterior
ACGTTGTAGTAACGAG-1	Neural_Anterior
ACTAAAGCAACTAGAA-1	Neural_Anterior
ACTAAAGCAAGTGTCC-1	Neural_Posterior
ACTAAAGCAGCAAGTG-1	Neural_Anterior
ACTAACCAGACTATTG-1	Neural_Anterior
ACTAACCAGAGCAAGC-1	Neural_Posterior
ACTAACCAGCTATATG-1	Neural_Anterior
ACTAACCAGCTGGAAA-1	Neural_Posterior
ACTAACGGTCCGGTTC-1	Neural_Anterior
ACTAACGGTCCGTAGG-1	Neural_Anterior
ACTAACTCAATTGAAG-1	Neural_Anterior
ACTAACTCATAATGAG-1	Neural_Posterior
ACTAACTCATGAATAG-1	Neural_Posterior
ACTAACTCATGTTGCA-1	Neural_Posterior
ACTAATCCACAAGCCT-1	Neural_Posterior
ACTAATCCACTAAGAA-1	Neural_Anterior
ACTAGGCGTCAAGACC-1	Neural_Posterior
ACTAGGCGTGGTTAGC-1	Neural_Posterior
ACTAGGCGTTCGCGCT-1	Neural_Anterior
ACTAGGCGTTGGTTGA-1	Neural_Anterior
ACTATCCGTAACTACG-1	Neural_Anterior
ACTATCCGTCATGCAA-1	Neural_Anterior
ACTATCCGTGACATGC-1	Neural_Posterior
ACTATGTCAATGAATG-1	Neural_Anterior
ACTATGTCAGGAACTG-1	Neural_Posterior
ACTATGTCATGATTGT-1	Neural_Anterior
ACTCACCTCACCTGTC-1	Neural_Posterior
ACTCACCTCTACCTAT-1	Neural_Posterior
ACTCACCTCTCCTCTT-1	Neural_Anterior
ACTCACTGTAAACAAG-1	Neural_Anterior
ACTCACTGTCATTAGG-1	Neural_Posterior
ACTCACTGTCGAAGTC-1	Neural_Posterior
ACTCACTGTCGCAATA-1	Neural_Anterior
ACTCACTGTGACCTGG-1	Neural_Posterior
ACTCACTGTGAGCGAA-1	Muscle
ACTCACTGTGTTCCCA-1	Neural_Posterior
ACTCAGTAGCTCATAA-1	Neural_Posterior
ACTCAGTAGTTATGTG-1	Neural_Posterior
ACTCCTCAGGTCCACA-1	Neural_Anterior
ACTCGCTTCACTCAAA-1	Neural_Posterior
ACTCGCTTCCTGCGAA-1	Neural_Anterior
ACTGAAACAGCAATAA-1	Neural_Posterior
ACTGAAACAGTAGGAT-1	Neural_Posterior
ACTGAAACATCACAGC-1	Neural_Posterior
ACTGAAACATTGTGCA-1	Neural_Anterior
ACTGAATGTATTTGCC-1	Neural_Anterior
ACTTACAAGACTATTG-1	Neural_Posterior
ACTTACAAGTAGGCGG-1	Neural_Posterior
ACTTACTTCAGTTCCC-1	Neural_Anterior
ACTTACTTCCATAATG-1	Neural_Posterior
ACTTACTTCCGTCCAT-1	Somites
ACTTAGGGTCTTTATG-1	Neural_Anterior
ACTTAGTCAGCACGAA-1	unassigned
ACTTAGTCATGTTGGC-1	Neural_Posterior
ACTTATCTCAATCATG-1	Neural_Anterior
ACTTATCTCGGTTAGT-1	Neural_Posterior
ACTTATGAGCTATGAC-1	Neural_Anterior
ACTTATGAGGACCTCA-1	Neural_Anterior
ACTTATGAGGCGCACT-1	Neural_Posterior
ACTTATGAGGGTTAGA-1	Neural_Anterior
ACTTATGAGGTTTGCG-1	Muscle
ACTTATGAGTTAGCCG-1	Neural_Anterior
ACTTATGAGTTTGTCT-1	Somites
ACTTCGCTCAAGGACA-1	Neural_Posterior
ACTTCGCTCGTCCTTA-1	Neural_Anterior
ACTTGAATCTACCTAT-1	Neural_Posterior
ACTTGCACAATCCTGA-1	Neural_Posterior
ACTTGCACAGTACCGT-1	Neural_Anterior
ACTTGTAAGCAAGACA-1	Neural_Anterior
ACTTGTAAGGTTACGT-1	Neural_Posterior
ACTTGTCGTAACGTGC-1	Neural_Anterior
ACTTGTCGTAATCACG-1	Somites
ACTTGTCGTCAGGCCA-1	Neural_Anterior
ACTTGTCGTGAGGTGA-1	Neural_Anterior
ACTTGTCGTGTGTGGT-1	Neural_Posterior
ACTTGTCGTTAATGCG-1	Neural_Posterior
ACTTTGTTCCCGTTTA-1	Neural_Posterior
ACTTTGTTCGAGCTAT-1	Neural_Anterior
ACTTTGTTCTCACTAT-1	Neural_Posterior
AGAAACCCAAGTGAAC-1	Neural_Posterior
AGAAACCCAATCCTAG-1	Neural_Posterior
AGAAACCCACCCACCT-1	Neural_Posterior
AGAAACCCACTAGGTC-1	Neural_Posterior
AGAAACCCATGAGCAG-1	Neural_Anterior
AGAAACCCATTCCTGT-1	Neural_Anterior
AGAAACTAGACAAGTG-1	Neural_Anterior
AGAAACTAGCAAGGTA-1	Neural_Anterior
AGAAACTAGCGATACT-1	Neural_Posterior
AGAAACTAGTTATTCC-1	Neural_Anterior
AGAAAGGCAAGATTCT-1	Neural_Anterior
AGAACAAGTAAAGCAA-1	Neural_Posterior
AGAACAAGTTCAAGCA-1	Neural_Anterior
AGAACCAAGGAACCAA-1	Neural_Anterior
AGAACCGCAAGGTGCA-1	Neural_Anterior
AGAACCGCAAGTCGCT-1	Neural_Anterior
AGAACCGCAAGTGTCC-1	Neural_Anterior
AGAACCGCACATACTG-1	Neural_Anterior
AGAACCGCACATAGCC-1	Neural_Anterior
AGAACCGCACGGTACT-1	Neural_Anterior
AGAACCGCATAATCCG-1	Neural_Anterior
AGAAGGTGTCATGAGC-1	Neural_Anterior
AGAAGGTGTGCAATGC-1	Neural_Anterior
AGAAGGTGTTAGCCAA-1	Neural_Anterior
AGAAGGTGTTTATGGG-1	Neural_Anterior
AGAATCGAGAGGAAGG-1	Neural_Posterior
AGAATCGAGGATAAAC-1	Neural_Posterior
AGAATCTGTCACGGAT-1	Neural_Posterior
AGAATCTGTGTAATAC-1	Neural_Anterior
AGAATCTGTGTCACGG-1	Neural_Posterior
AGAATCTGTGTGCACG-1	Neural_Anterior
AGACAATAGCTAATTG-1	Neural_Anterior
AGACACGCAGGAACAT-1	Neural_Posterior
AGACCCGGTAAAGCGG-1	unassigned
AGACCCGGTAATAACC-1	Neural_Anterior
AGACCCGGTCACACCC-1	Neural_Anterior
AGACCCGGTCAGGAAG-1	Neural_Anterior
AGACCCGGTGTGAGGA-1	Neural_Posterior
AGACCCGGTTGCTGGG-1	Neural_Posterior
AGACTATGTGCCTCAC-1	Somites
AGACTATGTGCTTTAC-1	Muscle
AGACTATGTGGTTAGC-1	Neural_Anterior
AGACTATGTTGGTTAG-1	Neural_Posterior
AGAGAAGCAACTAACT-1	Neural_Posterior
AGAGAAGCACAATACT-1	Neural_Anterior
AGAGAAGCACAGAAAC-1	Neural_Posterior
AGAGAAGCACATACTG-1	Neural_Posterior
AGAGAGGAGGAACCAA-1	Neural_Posterior
AGAGAGGAGGAACCGG-1	Neural_Posterior
AGAGAGGAGGACACTT-1	Neural_Anterior
AGAGAGGAGTGAGCAA-1	Neural_Posterior
AGAGATTAGCCGCTTT-1	Neural_Anterior
AGAGATTAGCGCATTG-1	Neural_Anterior
AGAGATTAGGTGAGAC-1	Neural_Anterior
AGAGGAACACCTCACC-1	Neural_Posterior
AGAGGAACAGCACGTT-1	Neural_Posterior
AGAGGAACATAAACCT-1	Neural_Anterior
AGAGGATGTACCGGAT-1	Neural_Anterior
AGAGGATGTCCCGGAA-1	Neural_Posterior
AGAGGATGTTTACGTC-1	Neural_Posterior
AGAGGATGTTTGTTGC-1	Neural_Posterior
AGATGAAGTGGATTGC-1	Neural_Anterior
AGATGCTTCACTAGGT-1	Neural_Anterior
AGATGCTTCCACCTTA-1	Neural_Anterior
AGATGCTTCCCATAGG-1	Neural_Anterior
AGATGCTTCCTAAGTA-1	Neural_Posterior
AGATGCTTCCTGGCTT-1	Neural_Posterior
AGATGCTTCGATAACC-1	Neural_Posterior
AGATGCTTCTTGAGCG-1	Neural_Posterior
AGCAAATAGCTATATG-1	Neural_Anterior
AGCAAATAGTACTGGT-1	Neural_Posterior
AGCAACAAGACAAGTG-1	Neural_Posterior
AGCAACAAGTCCTGAG-1	Neural_Anterior
AGCAAGGGTAGCCTCC-1	Neural_Anterior
AGCAAGGGTTCACCAT-1	Neural_Anterior
AGCAATACAATTTGGT-1	Neural_Posterior
AGCAATACACAGGAAT-1	Neural_Anterior
AGCAATACATTATGGT-1	Neural_Anterior
AGCAATTGTCATCATC-1	Neural_Anterior
AGCAATTGTGCTAGAC-1	Neural_Anterior
AGCAATTGTGCTCACC-1	Somites
AGCAATTGTTGTTGGA-1	Somites
AGCACAGCACTAAGAA-1	Neural_Posterior
AGCACAGCAGCTTAGC-1	Neural_Posterior
AGCACAGCATAAGTCT-1	Neural_Anterior
AGCACAGCATTATGAC-1	Neural_Posterior
AGCACTAGTTTATCTG-1	Neural_Anterior
AGCACTTAGACAAACG-1	Neural_Anterior
AGCACTTAGGCTACAT-1	Neural_Posterior
AGCAGGTAGCTATTAG-1	Neural_Anterior
AGCAGGTAGGCGTAAA-1	Neural_Posterior
AGCAGGTAGTATTGCA-1	Neural_Anterior
AGCATCCCAAACCTAT-1	Neural_Anterior
AGCATCCCACCCACCT-1	Neural_Posterior
AGCATCCCAGGACACA-1	Muscle
AGCATCCCATGCTCCC-1	Neural_Anterior
AGCATTTCACGCAACT-1	Neural_Anterior
AGCCGCTAGAGGATAT-1	Neural_Posterior
AGCCGCTAGGCTGTCA-1	Neural_Posterior
AGCCGCTAGGTCCTGA-1	Neural_Anterior
AGCCGCTAGTTTCCGC-1	Neural_Anterior
AGCCGGTTCAACCAAC-1	Somites
AGCCGGTTCCTCCTAA-1	Neural_Anterior
AGCCGGTTCGCATTAA-1	Neural_Anterior
AGCCTAAGTAATCCCT-1	Neural_Posterior
AGCCTAAGTCAATACG-1	Neural_Posterior
AGCCTAAGTCCTTCTC-1	Neural_Anterior
AGCCTAAGTTTCAGGA-1	Neural_Anterior
AGCCTAAGTTTGGTTC-1	Neural_Posterior
AGCCTAGTCCAGGAAA-1	Neural_Anterior
AGCCTAGTCCGGGACT-1	Neural_Posterior
AGCCTAGTCCGGTTGA-1	Neural_Anterior
AGCCTAGTCCGTTATT-1	Neural_Posterior
AGCCTCCGTAGCCTCC-1	Neural_Anterior
AGCCTCCGTCCCGGAA-1	Neural_Anterior
AGCCTCCGTCTCAGCC-1	Neural_Posterior
AGCCTCCGTTTGCAGA-1	Neural_Posterior
AGCCTGGGTTAAATGC-1	Neural_Posterior
AGCCTGGGTTACGCGG-1	Neural_Posterior
AGCCTGGGTTATGTGG-1	Neural_Anterior
AGCGATTTCAATTGGC-1	Neural_Anterior
AGCGATTTCATGTTTC-1	Neural_Posterior
AGCGATTTCCTTCTAG-1	Neural_Anterior
AGCGATTTCTGGCATG-1	Neural_Anterior
AGCGCCTAGCAAGGAC-1	Neural_Anterior
AGCGCCTAGCAGGCCT-1	Neural_Anterior
AGCGCCTAGGGATGAC-1	Neural_Anterior
AGCGCCTAGGTAAGCA-1	Neural_Anterior
AGCGCTCAGAAACTGG-1	Neural_Anterior
AGCGCTCAGAATCTCA-1	Neural_Posterior
AGCGCTCAGCATGTTA-1	Neural_Posterior
AGCGCTCAGCTACTGG-1	Neural_Posterior
AGCGCTCAGCTGTAAC-1	Neural_Anterior
AGCGGACCAATTAAGG-1	Neural_Anterior
AGCGGACCAGTTTCTC-1	Neural_Anterior
AGCGTGCTCGAGGTGG-1	NMPs
AGCGTGCTCTCAATGA-1	Neural_Anterior
AGCGTGCTCTCGCCCA-1	Neural_Posterior
AGCGTGCTCTGCAAAC-1	unassigned
AGCTAAACAATATGGA-1	Neural_Anterior
AGCTAAACACCTATAG-1	Neural_Posterior
AGCTAAACAGGCTTCG-1	Neural_Anterior
AGCTAACTCATGTCAA-1	Neural_Anterior
AGCTAACTCCTCAGCT-1	Neural_Posterior
AGCTAACTCCTCCCTC-1	Neural_Posterior
AGCTACGTCAAGCGCC-1	Neural_Anterior
AGCTACGTCACTAAGC-1	Neural_Anterior
AGCTACTAGGTGCGGA-1	Neural_Posterior
AGCTAGTTCAGGGCCT-1	Neural_Posterior
AGCTAGTTCATTACAG-1	unassigned
AGCTAGTTCCTAATTC-1	Neural_Anterior
AGCTAGTTCCTACCTA-1	Neural_Posterior
AGCTAGTTCTCTAGCC-1	Neural_Anterior
AGCTATATCCACCTTA-1	Neural_Anterior
AGCTATATCCGCCTAT-1	Neural_Anterior
AGCTCATAGCACGTTG-1	Neural_Anterior
AGCTCATAGCTTAGCG-1	Neural_Anterior
AGCTCATAGGCGGATG-1	Neural_Posterior
AGCTCATAGTAACGGA-1	Somites
AGCTCATAGTTATCTC-1	Neural_Anterior
AGCTGCTCACAAACTT-1	Neural_Anterior
AGCTGCTCACCGGTAT-1	Somites
AGCTGCTCATGGTTAT-1	Neural_Posterior
AGCTTAATCATGGTGT-1	Neural_Anterior
AGCTTAATCCGGTATG-1	Neural_Anterior
AGCTTAATCGATTATG-1	Neural_Posterior
AGCTTAATCGTTAGCG-1	Neural_Anterior
AGCTTCCTCGCAATCG-1	Neural_Anterior
AGCTTGGTCAAACCGT-1	Neural_Anterior
AGCTTGGTCATAACTG-1	Neural_Posterior
AGCTTGGTCCGCAACA-1	Somites
AGCTTTAAGGACCGCT-1	Neural_Anterior
AGCTTTAAGGCAGGTG-1	Neural_Posterior
AGCTTTAAGTTGGCCA-1	Neural_Posterior
AGGAAACGTGCCGCAA-1	Somites
AGGAAACGTTACAAAC-1	Neural_Anterior
AGGAACCAGTAGGCGG-1	Neural_Posterior
AGGAACCAGTTACTTC-1	Neural_Anterior
AGGAACGGTAATCACG-1	Neural_Posterior
AGGAACGGTACCTTAC-1	Neural_Anterior
AGGAACGGTGCATTAG-1	Neural_Posterior
AGGAACGGTTATCCTA-1	Neural_Posterior
AGGACGTAGAGGATAT-1	Neural_Posterior
AGGACGTAGTAGGCGG-1	Muscle
AGGACTAAGCATGAAG-1	Neural_Anterior
AGGACTAAGTACCGCA-1	Neural_Anterior
AGGACTAAGTCCTGAG-1	Neural_Anterior
AGGAGCTAGAGGATAT-1	Somites
AGGAGCTAGGACCAGG-1	Neural_Posterior
AGGAGCTAGGACCTTG-1	Neural_Posterior
AGGAGCTAGGTCCTGA-1	Neural_Anterior
AGGATATAGCACGTTG-1	Neural_Posterior
AGGATATAGCTCCTAC-1	Neural_Anterior
AGGATCCGTCTAACCT-1	Neural_Posterior
AGGATCCGTCTTGCTG-1	Neural_Anterior
AGGATCCGTGAGAAAC-1	Neural_Posterior
AGGATCCGTGTTTCAC-1	Neural_Anterior
AGGATGCAGCGGATAA-1	Neural_Anterior
AGGATGCAGTTAGGCT-1	Neural_Anterior
AGGATGTCAACCTAAT-1	Neural_Posterior
AGGATGTCAATAGTCT-1	Neural_Anterior
AGGATGTCAATTTAGC-1	Neural_Anterior
AGGATGTCACTTAGGC-1	Neural_Posterior
AGGATGTCATCCAGGT-1	NMPs
AGGATGTCATCGTTCT-1	Neural_Posterior
AGGATTGAGACTATTG-1	Neural_Posterior
AGGATTGAGCAGGTTT-1	Neural_Anterior
AGGATTGAGTAACGGA-1	Neural_Anterior
AGGATTGAGTGAGCGG-1	Neural_Anterior
AGGCAATCACATAGCC-1	Neural_Posterior
AGGCAGGTCCCTTGCG-1	Neural_Anterior
AGGCCCAGTAGTTACG-1	Neural_Anterior
AGGCCCAGTCCACAAA-1	Neural_Posterior
AGGCCCAGTCCTAGTT-1	Neural_Anterior
AGGCCCAGTGTTGCTT-1	Neural_Posterior
AGGCCCAGTTGCATCT-1	Neural_Anterior
AGGCCCAGTTTGTTGC-1	Neural_Posterior
AGGCGGATCTAGCGTG-1	Neural_Posterior
AGGCTAAAGCTTAGCG-1	Neural_Anterior
AGGCTAAAGGATCACT-1	Neural_Anterior
AGGCTAAAGGGATGAC-1	unassigned
AGGCTAGCAGCATGTC-1	Neural_Anterior
AGGGCCTTCACCTGTC-1	Neural_Posterior
AGGGCCTTCATTACTC-1	Neural_Posterior
AGGGCCTTCCCTCAAC-1	Neural_Anterior
AGGGCCTTCCGGTTGA-1	Muscle
AGGGCCTTCCTTCTAG-1	Neural_Anterior
AGGGCCTTCCTTGTTG-1	Neural_Posterior
AGGGCCTTCGAGCTAT-1	Neural_Anterior
AGGGCCTTCGGTTAGT-1	Neural_Anterior
AGGGTTGCATCATGTG-1	Neural_Posterior
AGGTAACCACATTAAC-1	Neural_Anterior
AGGTAACCACTCGCTC-1	Neural_Posterior
AGGTAACCATTAGGTT-1	Neural_Anterior
AGGTACGCACCCACCT-1	Neural_Anterior
AGGTACGCACTGACTA-1	Neural_Posterior
AGGTACGCAGGATTAA-1	Neural_Anterior
AGGTCAAAGTGAGAGC-1	Neural_Posterior
AGGTCCGGTAATAACC-1	Somites
AGGTCCGGTGACATAT-1	Neural_Anterior
AGGTCTTAGGACCTTG-1	Neural_Posterior
AGGTCTTAGTTCCTCA-1	Neural_Anterior
AGGTCTTAGTTGTCAA-1	Neural_Posterior
AGGTGAATCAATACGC-1	Neural_Anterior
AGGTGAATCAATGTCA-1	Neural_Anterior
AGGTGAATCACCGGTA-1	Neural_Anterior
AGGTGAATCCCTTGCG-1	Neural_Posterior
AGGTGAGGTAGCAGCT-1	Neural_Posterior
AGGTGAGGTCACAGCG-1	Neural_Posterior
AGGTGAGGTCATGAGC-1	Neural_Anterior
AGGTGAGGTCTATCGT-1	Somites
AGGTGAGGTTAAGGTT-1	Neural_Posterior
AGGTTAACAAGGTCCT-1	Neural_Anterior
AGGTTAACAATCATGT-1	Neural_Anterior
AGGTTAACAGCAAATA-1	Neural_Anterior
AGGTTAACAGTCTATG-1	Neural_Anterior
AGGTTACTCATGCATA-1	Neural_Posterior
AGGTTACTCGTACCGA-1	Neural_Posterior
AGGTTAGAGCATGACT-1	unassigned
AGGTTAGAGTAGGATG-1	Neural_Anterior
AGGTTGCGTACTGATG-1	Neural_Posterior
AGGTTGCGTAGTCAAT-1	Neural_Anterior
AGGTTGCGTGCTTACT-1	Neural_Anterior
AGGTTTATCGCTAAGT-1	Neural_Anterior
AGGTTTGGTATTGTCC-1	Neural_Posterior
AGGTTTGGTGAGCAAG-1	Neural_Posterior
AGTAAACAGAGCAAGC-1	Neural_Anterior
AGTAAACAGGGACGCA-1	Neural_Anterior
AGTAAACAGGTGCTGC-1	Neural_Anterior
AGTAACACAAATTCGT-1	Neural_Anterior
AGTAACACACGGTACT-1	Neural_Posterior
AGTAACACATAAAGCA-1	Neural_Anterior
AGTAACCTCAGCACCA-1	Neural_Anterior
AGTAACGAGCTTGCTC-1	Neural_Anterior
AGTAAGTAGAGGGACT-1	Neural_Posterior
AGTAAGTAGCACGTTG-1	Neural_Anterior
AGTAAGTAGCGCTAAT-1	Somites
AGTAAGTAGGGACTAA-1	Neural_Anterior
AGTAAGTAGGGCTAAA-1	Neural_Anterior
AGTAATGCAAACATAG-1	Neural_Anterior
AGTAATGCAAATACCT-1	Neural_Posterior
AGTAATGCAGCAACCT-1	Neural_Anterior
AGTAATGCAGTTATCG-1	Neural_Anterior
AGTAATGCATGTCGCG-1	Neural_Anterior
AGTAATGCATGTTGTG-1	Neural_Anterior
AGTACGCGTAAAGCGG-1	Neural_Anterior
AGTACGCGTCAAACTG-1	Neural_Anterior
AGTACGCGTCGCAAAC-1	Neural_Anterior
AGTACGCGTGAGAAAC-1	Neural_Anterior
AGTACGCGTGCTCCAC-1	Neural_Posterior
AGTAGCTTCCTGGTGA-1	Neural_Anterior
AGTAGCTTCGGCTAGC-1	Neural_Posterior
AGTAGCTTCGTGCCTT-1	Neural_Anterior
AGTAGGATCCAATTAG-1	Neural_Posterior
AGTATAGCATGAATCT-1	Neural_Anterior
AGTCAAGAGACTTACA-1	Neural_Anterior
AGTCAAGAGCAAGGGT-1	Neural_Anterior
AGTCAAGAGTTTGTCT-1	Neural_Anterior
AGTCAATGTTAAATGC-1	Muscle
AGTCAGGCAGCAAGTG-1	Neural_Posterior
AGTCAGGCAGGAATCG-1	Neural_Anterior
AGTCAGGCATAATGTC-1	Muscle
AGTCAGGCATGGCCTG-1	Neural_Anterior
AGTCAGGCATGTTGCA-1	Neural_Anterior
AGTCCTGAGAACCTGT-1	Somites
AGTCCTGAGCCAGGTC-1	Neural_Posterior
AGTCCTTGTAGCCATA-1	NMPs
AGTCCTTGTAGGATTT-1	Neural_Anterior
AGTCCTTGTATTGGTG-1	Neural_Anterior
AGTCGCATCACTTCAT-1	Neural_Anterior
AGTCGCATCTTAGGGT-1	Neural_Anterior
AGTCTTGCAAGCTTAT-1	Neural_Anterior
AGTCTTGCACCTACGG-1	Neural_Anterior
AGTCTTGCAGGCTACT-1	Neural_Anterior
AGTGAACCACAAAGAC-1	Neural_Anterior
AGTGAACCACTATGGC-1	Neural_Posterior
AGTGATGAGGGACGCA-1	Neural_Posterior
AGTGCACGTGAACAAA-1	Muscle
AGTGCCGGTGCTGTAA-1	Neural_Posterior
AGTGCGGAGCTGAGGG-1	Neural_Anterior
AGTGCGGAGTTTGAGC-1	Neural_Anterior
AGTGGACAGCAGGCCT-1	Neural_Anterior
AGTGTGGCAAACCTAT-1	Neural_Anterior
AGTGTGGCAATTTAGC-1	Somites
AGTGTGGCATGAAATG-1	Neural_Posterior
AGTGTTTCAAGGTATA-1	Neural_Anterior
AGTGTTTCACCTGCCT-1	Neural_Anterior
AGTTACATCAGTTCCC-1	Neural_Anterior
AGTTACATCCAACTGG-1	Neural_Posterior
AGTTACATCCTTTACG-1	Neural_Anterior
AGTTACTCAAGGTATA-1	Neural_Anterior
AGTTATGTCAATAGCC-1	Neural_Posterior
AGTTATGTCATCCACC-1	Neural_Posterior
AGTTATGTCGTTATAG-1	Neural_Anterior
AGTTATGTCTCGACCT-1	Neural_Anterior
AGTTGCAGTCATCCTG-1	Neural_Posterior
AGTTGCAGTGTGAGAG-1	Neural_Anterior
AGTTGCAGTTAAATGC-1	Neural_Anterior
AGTTGCAGTTTACTTG-1	Muscle
AGTTGCGTCAATACGC-1	Neural_Anterior
AGTTGCGTCACAGGAA-1	Neural_Anterior
AGTTGCGTCGGGACTC-1	Neural_Posterior
AGTTGCGTCGTAACGT-1	Neural_Posterior
AGTTGCGTCTTGTTCG-1	Neural_Anterior
AGTTGGCGTACCCACC-1	Neural_Anterior
AGTTGGCGTCGTAAAT-1	Somites
AGTTGGCGTGGACCTG-1	Neural_Posterior
AGTTGGCGTTCCATTA-1	Neural_Posterior
AGTTGGCGTTGCACGG-1	Muscle
AGTTGGCGTTTATTCG-1	Neural_Anterior
AGTTGTCAGCTTTGTT-1	Muscle
AGTTGTCAGTGAACAG-1	Neural_Anterior
AGTTGTCAGTTACCGG-1	Neural_Anterior
AGTTTGATCCAAGTTA-1	Neural_Posterior
AGTTTGATCGGCTAGC-1	Neural_Posterior
AGTTTGATCTTAAGTG-1	Neural_Anterior
AGTTTGCAGACTTACA-1	Neural_Anterior
AGTTTGCAGGCTGGCT-1	Neural_Anterior
AGTTTGCAGGGCTTTG-1	Muscle
AGTTTGCAGTAACTCA-1	Neural_Anterior
AGTTTGCAGTCCTTTG-1	Neural_Anterior
ATAACGACAATATAGG-1	Neural_Posterior
ATAACGACACATAACT-1	Neural_Posterior
ATAACGACAGAAATGC-1	Neural_Anterior
ATAACGACAGGGAGCT-1	Neural_Anterior
ATAAGCCTCACAGCCA-1	Neural_Anterior
ATAAGCCTCAGTGAAG-1	Neural_Anterior
ATAAGCCTCATAATCG-1	Neural_Anterior
ATAAGCCTCATCCTGC-1	Neural_Posterior
ATAAGCCTCCGTAAAC-1	Neural_Posterior
ATAAGCCTCGGTTTCC-1	Neural_Posterior
ATAAGCCTCTCAATAG-1	Neural_Anterior
ATAAGCCTCTGGCTTC-1	Neural_Posterior
ATAAGCCTCTTGACCC-1	Neural_Anterior
ATAATGGCAATATGGA-1	Neural_Anterior
ATAATGGCAGCCTAAC-1	Neural_Anterior
ATAATGGCAGGCTGTT-1	Somites
ATAGATGCAACAACAA-1	Neural_Anterior
ATAGATGCACGTGCTG-1	Neural_Anterior
ATAGATGCACTCGCTC-1	unassigned
ATAGATGCAGGTCCTG-1	Neural_Posterior
ATAGCATGTCAAGTAT-1	Neural_Posterior
ATAGCATGTGGGAACA-1	Neural_Anterior
ATAGCATGTTTGGCTT-1	Neural_Posterior
ATAGGTACAACCCTAA-1	Neural_Anterior
ATAGGTACAGTAGGTG-1	Neural_Anterior
ATATAGGCAAAGCCTC-1	Neural_Anterior
ATATAGGCACCTGCTC-1	unassigned
ATATAGGCAGGCGAGT-1	Neural_Anterior
ATATAGGCATCCCGCT-1	Neural_Posterior
ATATGCATCATTAGGC-1	Neural_Posterior
ATATGCATCGGTAACT-1	Neural_Anterior
ATATGCATCTACCTCA-1	Neural_Anterior
ATATGCTCAGCATGAG-1	Neural_Anterior
ATATGCTCAGGACCTT-1	Muscle
ATATGCTCATGAATCT-1	Neural_Posterior
ATATGCTCATTGTTGG-1	Neural_Posterior
ATATGGTGTAATAACC-1	Neural_Anterior
ATATGGTGTACTTAGG-1	Somites
ATATGGTGTTTGTGGA-1	Neural_Anterior
ATATGTCCAATTGACT-1	Neural_Anterior
ATCAAGACAGGCTACT-1	Neural_Anterior
ATCAAGCTCATGTGGT-1	Neural_Anterior
ATCAAGCTCCAAATCA-1	Neural_Anterior
ATCAATCCAACTGGCT-1	Neural_Anterior
ATCAATCCACTGGCTG-1	Neural_Anterior
ATCACAATCATAACTG-1	Neural_Posterior
ATCACAATCCCATAGG-1	Neural_Anterior
ATCACAATCGGTAACT-1	Neural_Anterior
ATCACAATCTCAATTC-1	Neural_Anterior
ATCACACAGGTGTTAC-1	Neural_Posterior
ATCACACAGTAAGGGC-1	Neural_Posterior
ATCACACAGTCCTGAG-1	Neural_Anterior
ATCACCCTCAAACCGT-1	Neural_Posterior
ATCACCCTCATCCTGC-1	Neural_Posterior
ATCACCCTCTAGCGTG-1	Neural_Posterior
ATCACCCTCTGCAAAC-1	Neural_Anterior
ATCACTAAGCCTGATG-1	Neural_Posterior
ATCACTAAGTCAATTG-1	Neural_Anterior
ATCACTAAGTGAGAGC-1	Neural_Posterior
ATCACTAAGTTAGCCG-1	Neural_Posterior
ATCAGGTTCCTTCGTA-1	Neural_Posterior
ATCATCAAGAAAGGAA-1	Neural_Posterior
ATCATCAAGCCGGTAC-1	Neural_Posterior
ATCATCAAGCGATAGA-1	Neural_Anterior
ATCATCAAGCGGGCAA-1	Neural_Anterior
ATCATCAAGTGTGATC-1	Neural_Posterior
ATCATGTCAGCTTAGC-1	Neural_Anterior
ATCATGTCAGTCTAAT-1	Neural_Posterior
ATCATGTCATGCAACC-1	Neural_Anterior
ATCCAACAGGACCGCT-1	Neural_Anterior
ATCCACCTCCTTGAGG-1	Neural_Anterior
ATCCATAAGCTAATTG-1	Neural_Anterior
ATCCATAAGGACCAGG-1	Neural_Anterior
ATCCATAAGTAAGGGC-1	Neural_Anterior
ATCCATAAGTTTGAGC-1	Neural_Posterior
ATCCCGCGTCAAGTGC-1	Neural_Posterior
ATCCCGCGTCTTACTA-1	Neural_Anterior
ATCCCGCGTTACATCC-1	Neural_Posterior
ATCCCGCGTTTAACCC-1	Neural_Anterior
ATCCGTGAGCAAGACA-1	Neural_Anterior
ATCCTCATCCAAGTGT-1	Neural_Anterior
ATCCTCATCCCGCCTA-1	Neural_Posterior
ATCCTCATCTAACCTT-1	Neural_Anterior
ATCCTCATCTAGCTAA-1	Neural_Posterior
ATCCTGACATAATCGT-1	Neural_Posterior
ATCCTGACATTAGCCA-1	Neural_Anterior
ATCCTTAGTAGACAAA-1	Neural_Anterior
ATCCTTAGTTAGGTGC-1	Neural_Posterior
ATCCTTAGTTGTAACG-1	Neural_Posterior
ATCCTTAGTTTGGTTC-1	Neural_Posterior
ATCGAGGCAAGCCAGA-1	Neural_Posterior
ATCGAGGCAGGAATCG-1	Neural_Posterior
ATCGAGGCATAAGGAC-1	Neural_Anterior
ATCGAGGCATTCAGCA-1	Neural_Posterior
ATCGCCCGTAAACAAG-1	Neural_Posterior
ATCGCCCGTAGGATCC-1	Neural_Posterior
ATCGCCCGTGCTAGCG-1	Neural_Anterior
ATCGCCCGTGCTTACT-1	Neural_Posterior
ATCGCCCGTTTCCGGC-1	Neural_Posterior
ATCGCTTGTCATAGAT-1	Neural_Anterior
ATCGCTTGTTTACCGT-1	Neural_Anterior
ATCGGCCAGAACCTAC-1	Neural_Posterior
ATCGGCCAGGCACAGG-1	Neural_Posterior
ATCTATGAGCTAAGTC-1	Neural_Anterior
ATCTATGAGGGCTAAA-1	Neural_Anterior
ATCTATGAGTTGTCTT-1	Neural_Anterior
ATCTTTGGTAAAGCGG-1	Neural_Posterior
ATCTTTGGTCACTCGC-1	Neural_Posterior
ATCTTTGGTTGTAAAC-1	Neural_Anterior
ATGAAGCCAAGGCCAA-1	Neural_Anterior
ATGAAGTAGCCTGACA-1	Neural_Anterior
ATGAAGTAGGAGGTTA-1	Neural_Anterior
ATGAAGTAGGCGCATC-1	Neural_Anterior
ATGAAGTAGGCGGATG-1	Neural_Anterior
ATGAAGTAGGCTAAGA-1	Neural_Posterior
ATGAAGTAGTCCTTCA-1	Neural_Anterior
ATGAAGTAGTGAGGTA-1	Neural_Anterior
ATGAAGTAGTTATGTG-1	Neural_Anterior
ATGAATGCAAAGCTCC-1	Neural_Anterior
ATGAATGCAGGCTAAG-1	Somites
ATGACAACAGCCAGAA-1	unassigned
ATGACCAGTATCTGGA-1	Neural_Anterior
ATGACCAGTCATCATC-1	Neural_Anterior
ATGACCAGTCCCGGAA-1	Neural_Anterior
ATGACCAGTTCCTGAT-1	Neural_Posterior
ATGACGAAGGGTCTAT-1	Neural_Anterior
ATGACGAAGTGTGATC-1	Neural_Anterior
ATGACGAAGTTAGCTA-1	Neural_Posterior
ATGACTCAGCTCATAA-1	Neural_Posterior
ATGACTCAGGCTACTG-1	Neural_Anterior
ATGACTCAGTGTGATC-1	Neural_Posterior
ATGAGCCGTAGGTTGC-1	Neural_Anterior
ATGAGCCGTATTGAGT-1	Muscle
ATGAGCCGTGTAATAC-1	Neural_Anterior
ATGAGCCGTTGCACGG-1	Neural_Anterior
ATGATGACAACTAGCC-1	Neural_Posterior
ATGATGACAATGCCCG-1	Neural_Posterior
ATGATGGAGACACCGC-1	Neural_Anterior
ATGATGGAGCTAAGTC-1	Neural_Anterior
ATGATGGAGCTCCCTG-1	Neural_Posterior
ATGATGGAGTGTTGTA-1	Neural_Posterior
ATGATGGAGTTGTCTT-1	Neural_Posterior
ATGCAAACAGCTCATA-1	Neural_Posterior
ATGCATTCACCAGGTT-1	Neural_Anterior
ATGCCTGAGCTTAGTA-1	Neural_Anterior
ATGCGATTCATTAGGC-1	Neural_Posterior
ATGCTTAAGGCACAGG-1	Neural_Posterior
ATGCTTAAGGGCTAAA-1	Neural_Anterior
ATGCTTAAGTCCTTCA-1	Neural_Anterior
ATGCTTAAGTTATTCC-1	Neural_Anterior
ATGGACAAGAGGATAT-1	Neural_Anterior
ATGGACAAGGGTGAAC-1	Neural_Posterior
ATGGCCCAGCTAAGTC-1	Neural_Posterior
ATGGCCGGTAACGGGA-1	Neural_Anterior
ATGGCCGGTAAGGTCC-1	Neural_Posterior
ATGGCTAGTAATTAGC-1	Neural_Posterior
ATGGCTAGTGACATAT-1	Neural_Anterior
ATGGCTAGTGTTCCCA-1	Neural_Anterior
ATGGCTAGTTGTTGCT-1	Neural_Anterior
ATGGCTAGTTTGAGGC-1	Neural_Posterior
ATGGCTGTCCAACTGG-1	Neural_Anterior
ATGGCTGTCCGTAAAC-1	Neural_Posterior
ATGGCTTAGCGGCTGT-1	Neural_Posterior
ATGGCTTAGCTCAAAC-1	Neural_Anterior
ATGGCTTAGGCTCATG-1	Neural_Posterior
ATGGCTTAGTCTTGAA-1	Neural_Anterior
ATGGCTTAGTTAGCTA-1	Neural_Anterior
ATGGTCTAGCTAAAGG-1	Neural_Anterior
ATGGTGCGTATTGAGT-1	Neural_Posterior
ATGGTGCGTCCTAGTT-1	Neural_Anterior
ATGGTGCGTGCAATAT-1	Neural_Anterior
ATGGTTATCCAACTGG-1	Neural_Anterior
ATGGTTATCCGCAAAT-1	Neural_Anterior
ATGGTTATCCTTAATC-1	Neural_Anterior
ATGGTTATCGTTATCT-1	Neural_Posterior
ATGTAACGTCAAGACC-1	Neural_Anterior
ATGTAACGTGATGGCT-1	Neural_Anterior
ATGTAACGTTTGTTGC-1	Somites
ATGTCAATCACGCCAA-1	Neural_Posterior
ATGTCAATCGCATCCT-1	Neural_Anterior
ATGTCAATCTCACTCA-1	Neural_Posterior
ATGTCATCACACAATT-1	Neural_Posterior
ATGTCATCACCAGCAT-1	unassigned
ATGTCCACACTGGCCA-1	Neural_Anterior
ATGTCCACAGAACCGA-1	Neural_Posterior
ATGTGAGAGCCAGTAT-1	Somites
ATGTGAGAGCGAAGTA-1	Neural_Anterior
ATGTGAGAGGCGAATA-1	Neural_Posterior
ATGTGAGAGTCATGCG-1	Neural_Posterior
ATGTGAGAGTGAGGTA-1	Neural_Anterior
ATGTGAGAGTGTTGCG-1	Somites
ATGTTCAAGACTATTG-1	Neural_Posterior
ATGTTCAAGAGGGACT-1	Neural_Anterior
ATGTTCAAGATGGACA-1	Neural_Anterior
ATGTTCAAGCTTACTT-1	Neural_Anterior
ATGTTCAAGGTGCGGA-1	Neural_Posterior
ATGTTCAAGTCATCCC-1	Neural_Anterior
ATGTTCAAGTTCCCAC-1	Neural_Posterior
ATGTTGTCAGAGAGCC-1	Neural_Posterior
ATGTTGTCATTAAACC-1	Neural_Anterior
ATGTTTGAGCCATCAG-1	Neural_Anterior
ATGTTTGAGTAAACCC-1	Neural_Posterior
ATTAACCCAATGCGCT-1	Neural_Posterior
ATTAACCCAGATTCAT-1	Neural_Posterior
ATTAACCCAGGAACCA-1	Neural_Anterior
ATTAACCCATGGAGGC-1	Neural_Posterior
ATTACCCGTCAATGTG-1	Neural_Anterior
ATTACCGCAACTGGCT-1	Neural_Posterior
ATTACCGCACCAGCAT-1	Neural_Anterior
ATTACCGCACTAAGCC-1	Neural_Posterior
ATTACCGCAGGACACA-1	Neural_Anterior
ATTACGTCAATTTGGT-1	Neural_Posterior
ATTACGTCACGTGCTG-1	Neural_Anterior
ATTACGTCACTTAGGC-1	Neural_Posterior
ATTACGTCAGGTATTT-1	Somites
ATTACGTCAGGTTTGC-1	Neural_Anterior
ATTACGTCATAATCGT-1	Neural_Anterior
ATTACTGAGACTATTG-1	Neural_Anterior
ATTACTGAGGCCATCA-1	Neural_Anterior
ATTACTGAGGCGCACT-1	Somites
ATTAGCGGTTACTTGC-1	Neural_Anterior
ATTAGCGGTTGGTTGA-1	Neural_Anterior
ATTAGCTCAAGCGAGC-1	Neural_Posterior
ATTAGCTCAATAAGCA-1	Neural_Posterior
ATTAGCTCAGGCAAGC-1	Neural_Anterior
ATTAGCTCAGTTTGGC-1	Neural_Anterior
ATTAGGTGTGAAACAA-1	Neural_Posterior
ATTAGTCCATAAGTCT-1	Neural_Anterior
ATTATCCTCACGCATG-1	Muscle
ATTATCCTCGCTTCTA-1	Neural_Anterior
ATTATGGTCAAACACC-1	Neural_Posterior
ATTATGGTCACACAGT-1	Neural_Anterior
ATTATGGTCATGACCG-1	Neural_Posterior
ATTATGGTCTTGAGCG-1	Neural_Anterior
ATTCAACCAAAGGCCA-1	Neural_Anterior
ATTCAACCAGGATGGC-1	Neural_Posterior
ATTCAACCATTAGCGC-1	Neural_Posterior
ATTCACTTCAACAAGG-1	Neural_Anterior
ATTCACTTCTTGATGA-1	Neural_Anterior
ATTCATGAGATGCCTG-1	Neural_Anterior
ATTCATGAGCTCCTAC-1	Neural_Posterior
ATTCATGAGGAGTCTT-1	Neural_Anterior
ATTCATGAGGGTGGAT-1	Neural_Anterior
ATTCATGAGTCTATGA-1	Neural_Posterior
ATTCCGGAGGCACAGG-1	Neural_Anterior
ATTCCTAGTGAGCGAA-1	Neural_Posterior
ATTCCTAGTGCACGCA-1	Neural_Anterior
ATTCCTAGTGCGCAAT-1	Muscle
ATTCCTAGTTTGGGCG-1	Neural_Anterior
ATTCCTCCAATAGCCC-1	Neural_Posterior
ATTCCTCCACAAACTT-1	Neural_Posterior
ATTCCTCCAGGTTTGC-1	Neural_Anterior
ATTCGTTTCAATACGC-1	Neural_Posterior
ATTCGTTTCCACCTGT-1	Neural_Posterior
ATTCGTTTCCCTCGCA-1	Neural_Posterior
ATTCGTTTCGTTATAG-1	Neural_Posterior
ATTCGTTTCTTAAGTG-1	Neural_Posterior
ATTCGTTTCTTAGTCT-1	Neural_Anterior
ATTGAAGCAATTAGGA-1	Neural_Anterior
ATTGAAGCAGGCCAAA-1	Somites
ATTGAAGCAGGCCTTG-1	Neural_Anterior
ATTGAAGCAGGCTTCG-1	Somites
ATTGACTCAAACAACA-1	Neural_Posterior
ATTGACTCATGATTGT-1	Neural_Posterior
ATTGCACAGACAACAG-1	Neural_Anterior
ATTGCACAGGGTCCAC-1	Neural_Anterior
ATTGCACAGGTCATTA-1	Neural_Anterior
ATTGCAGGTAACCAGC-1	Neural_Anterior
ATTGCAGGTGTTCCCA-1	Neural_Posterior
ATTGCAGGTTAGACCA-1	Neural_Posterior
ATTGCAGGTTTAAAGC-1	Neural_Anterior
ATTGCGCCATGGAGGC-1	Neural_Posterior
ATTGCTCGTAATCGGC-1	Neural_Posterior
ATTGCTCGTTAGGTTG-1	Neural_Anterior
ATTGCTCGTTCAAGCA-1	Neural_Anterior
ATTGGTTCAATTGCGC-1	Neural_Anterior
ATTGGTTCAGCAAATA-1	Neural_Posterior
ATTGGTTCAGCAACAG-1	Neural_Posterior
ATTGGTTCATGCTTAG-1	Neural_Anterior
ATTGTCCGTATTGAGT-1	Neural_Posterior
ATTGTCCGTTTCCACG-1	Neural_Posterior
ATTGTGATCATCCACC-1	Somites
ATTGTGATCCCGCCTA-1	Neural_Anterior
ATTGTGATCGATAACC-1	Neural_Anterior
ATTTAGCCAACTAGAA-1	Neural_Anterior
ATTTAGCCAGCAAGAT-1	Neural_Anterior
ATTTAGCCAGCGCTTG-1	Neural_Anterior
ATTTAGGTCATGCTTT-1	Somites
ATTTAGGTCCTTGCGT-1	Neural_Posterior
ATTTAGGTCGGGATTT-1	Neural_Posterior
ATTTAGGTCTCCTCTT-1	Neural_Anterior
ATTTAGGTCTTAGTCT-1	Neural_Posterior
ATTTGCAAGGAGCAAC-1	Neural_Anterior
ATTTGCAAGGCATTAC-1	Neural_Anterior
ATTTGCGCATAGCGGA-1	Neural_Anterior
ATTTGCGCATCACTTC-1	Neural_Posterior
ATTTGTGAGAGGAAGG-1	NMPs
ATTTGTGAGCACCACA-1	Neural_Posterior
CAAACAACAAGCTACC-1	Neural_Anterior
CAAACAACAAGCTTAT-1	Neural_Anterior
CAAACAACAGCCGCTA-1	Neural_Anterior
CAAACAACAGCTCAAC-1	Neural_Anterior
CAAACACTCGAGGAAC-1	Neural_Posterior
CAAACACTCTAACTGA-1	Neural_Anterior
CAAACATGTACGGTAC-1	Neural_Anterior
CAAACATGTGTCCAGG-1	Neural_Posterior
CAAACCGTCACAGGAA-1	Neural_Anterior
CAAACCGTCAGCAAAG-1	Neural_Anterior
CAAACCGTCCACCTTA-1	Somites
CAAACCGTCGGCCATA-1	Neural_Anterior
CAAACCGTCGGCTATG-1	Neural_Anterior
CAAACCGTCTAATTGG-1	Neural_Posterior
CAAACTGGTCAAAGAA-1	Neural_Posterior
CAAACTGGTTCGCTTG-1	Neural_Posterior
CAAACTGGTTTGACCT-1	Neural_Posterior
CAAAGCGCACAACCTA-1	Somites
CAAAGCGCACTTCATC-1	Neural_Posterior
CAAAGCGCATAAGTTC-1	Neural_Anterior
CAAAGCGCATGACTAT-1	Neural_Anterior
CAAAGCGCATTGTTGG-1	Neural_Anterior
CAAAGGATCCCGCATT-1	Neural_Anterior
CAAAGTGAGAGCAAGC-1	Neural_Anterior
CAAAGTGAGGGACGCA-1	Neural_Anterior
CAAAGTGAGTAAGGGC-1	Muscle
CAAATCATCATGCCTC-1	Neural_Anterior
CAAATCATCCGCTAGA-1	Neural_Posterior
CAAATCATCGGTTTCC-1	Neural_Anterior
CAAATCATCTAACCAA-1	Neural_Posterior
CAAATCATCTCAATAG-1	Neural_Anterior
CAAATCATCTTGGACG-1	Neural_Posterior
CAACAATGTAAGGTCC-1	Neural_Anterior
CAACAATGTTGTAAAC-1	Neural_Anterior
CAACAATGTTTAGCTC-1	Neural_Posterior
CAACAGGCAATAATCC-1	Neural_Anterior
CAACAGGCACAATGTT-1	Neural_Posterior
CAACAGGCACCTCGCT-1	Neural_Anterior
CAACAGGCAGGAAGCC-1	Neural_Anterior
CAACAGGCAGTTAAAG-1	Neural_Posterior
CAACCCGCAAGGTCCT-1	Muscle
CAACCCGCAAGTCGCT-1	Neural_Posterior
CAACCCGCAATCCTAG-1	Neural_Anterior
CAACCCGCAATTAAGG-1	Neural_Anterior
CAACCCGCAATTGCGC-1	Neural_Anterior
CAACCCGCACGGTACT-1	Neural_Anterior
CAACCCGCAGATTCAT-1	Neural_Anterior
CAACCCGCAGTTAAAG-1	Neural_Posterior
CAACCCTTCATTAGTG-1	Neural_Posterior
CAACCCTTCCGCTAGA-1	Neural_Anterior
CAACCCTTCTTGCAAA-1	Neural_Posterior
CAACTAATCCTAAGAC-1	Neural_Posterior
CAACTAGGTAAATTGC-1	Neural_Posterior
CAACTAGGTAATAACC-1	Neural_Anterior
CAACTAGGTTCCGGGA-1	Neural_Posterior
CAAGAACCACACAATT-1	Neural_Posterior
CAAGAACCAGAACCGA-1	Neural_Posterior
CAAGAACCAGGTCCTG-1	Neural_Anterior
CAAGAACCATCAGTAT-1	Neural_Posterior
CAAGACAAGAACAAGT-1	Neural_Anterior
CAAGACAAGTTGTCCC-1	Neural_Posterior
CAAGCTAGTCTTTATG-1	Neural_Anterior
CAAGCTAGTGTTGCTT-1	Neural_Anterior
CAAGGCCTCACAGCCA-1	Neural_Anterior
CAAGGCCTCCCGAACA-1	Neural_Anterior
CAAGGCCTCGGTTAGT-1	Neural_Posterior
CAAGGCTGTCTAACAG-1	Neural_Posterior
CAAGGGAGTGGACATC-1	Neural_Anterior
CAAGGTAAGCCAGGTC-1	Neural_Posterior
CAAGGTAAGCCTGGTA-1	Neural_Anterior
CAAGGTTTCACGCATG-1	Neural_Anterior
CAAGGTTTCATAACTG-1	Neural_Anterior
CAAGGTTTCGCCTAAG-1	Neural_Posterior
CAAGTAACAAGACTCC-1	Neural_Anterior
CAAGTAACAGGTTTGC-1	Neural_Anterior
CAAGTATGTTAAGCGC-1	Neural_Anterior
CAAGTGAAGCACAGCC-1	Muscle
CAAGTGAAGGTCCGTA-1	Neural_Posterior
CAAGTTATCATCCTGC-1	Neural_Anterior
CAAGTTATCTATCGCC-1	Neural_Anterior
CAATAAGCAACAGCCT-1	Neural_Anterior
CAATAAGCAGCAAATA-1	Neural_Posterior
CAATAAGCATCAGTAT-1	Neural_Anterior
CAATAGCTCATAGCCG-1	Neural_Posterior
CAATAGCTCATTACTC-1	Neural_Anterior
CAATAGCTCCACAATA-1	Neural_Anterior
CAATAGCTCCCTGGAA-1	Neural_Posterior
CAATAGCTCCTTTACG-1	Neural_Posterior
CAATAGCTCGTTTCGC-1	Neural_Posterior
CAATATGTCAATTACG-1	Neural_Posterior
CAATATGTCATCCACC-1	Neural_Anterior
CAATATGTCGCAAACT-1	Neural_Posterior
CAATATGTCGTCCTTA-1	Neural_Anterior
CAATCCCTCATGCTAA-1	Neural_Posterior
CAATCCCTCCGTTATT-1	Neural_Anterior
CAATCCCTCGGTCATG-1	Neural_Anterior
CAATCCTGTAACGAGG-1	Neural_Posterior
CAATCCTGTACCCACC-1	Neural_Posterior
CAATCCTGTAGTCAAT-1	Neural_Posterior
CAATCCTGTCACCAAA-1	Neural_Anterior
CAATCCTGTGCAATAT-1	Neural_Posterior
CAATCCTGTTAACGAT-1	Neural_Anterior
CAATCCTGTTTCCACG-1	Neural_Anterior
CAATCGCCAAAGCCTC-1	Neural_Posterior
CAATCGCCACTCGCTC-1	Neural_Anterior
CAATCTAAGCAGGTTT-1	Neural_Anterior
CAATCTAAGGCAGGTG-1	Neural_Posterior
CAATCTAAGTCAATCA-1	Neural_Posterior
CAATGAACACAGGAAT-1	Neural_Anterior
CAATGAACATACCCGG-1	Neural_Posterior
CAATGCCCAAAGCGCA-1	Neural_Posterior
CAATGCCCAATGAATG-1	Neural_Anterior
CAATGCCCATAGACCC-1	Neural_Posterior
CACAAGCGTAATCGTG-1	Neural_Anterior
CACAATATCAGGCTAT-1	Neural_Posterior
CACAATATCGGTCAGC-1	Neural_Anterior
CACAGGCTCAATTACG-1	Neural_Posterior
CACAGGGAGAGGGACT-1	Neural_Anterior
CACAGGGAGTATTGCA-1	Neural_Posterior
CACATACAGCTTAGCG-1	Neural_Anterior
CACATTAAGCGCATTG-1	Neural_Posterior
CACATTAAGGAGGCAT-1	Somites
CACATTAAGGCTACAT-1	Neural_Anterior
CACATTAAGGCTTAGT-1	Neural_Anterior
CACCGGTAGCCTCTCG-1	Neural_Anterior
CACCGGTAGGATTGAG-1	Neural_Posterior
CACCGGTAGTTTGGGT-1	Neural_Anterior
CACCTCAGTCTTTATG-1	Neural_Anterior
CACCTCAGTGATGATT-1	Neural_Anterior
CACCTCAGTGGTTATG-1	Neural_Posterior
CACCTCAGTTAAATGC-1	Neural_Anterior
CACCTCAGTTATAGCG-1	Neural_Posterior
CACCTGTTCCTAAATG-1	Neural_Anterior
CACGCAATCAAACACC-1	Neural_Posterior
CACGCAATCACACAGT-1	Neural_Anterior
CACGCAATCACAGCCA-1	Neural_Anterior
CACGCAATCATTTGCT-1	Neural_Anterior
CACGCAATCCAAATCA-1	Neural_Anterior
CACGCAATCCTAACGG-1	Neural_Posterior
CACGCTAAGATAAAGC-1	Neural_Anterior
CACGCTAAGTCACGAT-1	Neural_Posterior
CACTAAGGTAAGGTCC-1	Neural_Posterior
CACTAAGGTATTCGTC-1	Neural_Posterior
CACTAAGGTCACGAAC-1	Neural_Anterior
CACTAGCCAATAGTCT-1	Neural_Anterior
CACTAGCCAGGACCAA-1	Neural_Posterior
CACTGACCACAAAGAC-1	Neural_Anterior
CACTGACCAGGCTAGA-1	Neural_Anterior
CACTTAAAGAAAGCAT-1	Neural_Anterior
CACTTAAAGTATTGCA-1	Neural_Anterior
CACTTTGTCAAAGGCA-1	Neural_Posterior
CACTTTGTCAAGCCTG-1	Neural_Anterior
CACTTTGTCAGCAAAG-1	Somites
CACTTTGTCGAAGTAG-1	Neural_Anterior
CAGAACCGTTATCCGT-1	Neural_Anterior
CAGAATCTCACGCATG-1	Neural_Anterior
CAGAATCTCCTTGCAC-1	Neural_Posterior
CAGATTCAGAGGGACT-1	Neural_Posterior
CAGATTCAGCTGGACC-1	Neural_Anterior
CAGATTCAGGCCTTAG-1	Somites
CAGCAAGCAAACGGGC-1	Neural_Anterior
CAGCAAGCAATTGAAG-1	Neural_Posterior
CAGCAAGCATAAACCT-1	Neural_Posterior
CAGCATGTCTCACATT-1	Neural_Posterior
CAGCATTAGGCCTAAT-1	Neural_Anterior
CAGCCAATCACCTGCT-1	Neural_Posterior
CAGCCAATCAGCTAAC-1	Neural_Posterior
CAGCCAATCATAGACC-1	Neural_Posterior
CAGCCAATCATTAGCA-1	Neural_Anterior
CAGCCAATCTTAGGAC-1	Neural_Anterior
CAGCCTAAGCCACATG-1	Neural_Posterior
CAGCCTAAGGCTAAGA-1	Neural_Anterior
CAGCCTTTCATGGCTG-1	Neural_Posterior
CAGCCTTTCGTTCACC-1	Neural_Posterior
CAGCCTTTCTAATCTC-1	Neural_Posterior
CAGCCTTTCTCGACCT-1	Muscle
CAGCTAAGTCATCATC-1	Neural_Anterior
CAGCTAAGTCTAACAG-1	Neural_Posterior
CAGCTAAGTGGATTGC-1	Neural_Anterior
CAGCTAAGTTTGGTTC-1	Neural_Anterior
CAGCTATAGACACCGC-1	Neural_Anterior
CAGCTATAGCGAGTAA-1	Neural_Posterior
CAGCTATAGTTAGACC-1	Neural_Anterior
CAGCTATAGTTAGCCG-1	Neural_Posterior
CAGCTCAAGCGTGCAC-1	Neural_Posterior
CAGCTCAAGGCTTAAC-1	Neural_Anterior
CAGGAAGGTCATGCAA-1	Neural_Posterior
CAGGAAGGTGTTGTGA-1	Neural_Posterior
CAGGAAGGTTAAGCGC-1	Neural_Posterior
CAGGAAGGTTGTTGCT-1	Neural_Anterior
CAGGACCTCCTGTTCA-1	Neural_Anterior
CAGGATGCAATTAGGA-1	Neural_Posterior
CAGGATGCAATTTGGT-1	Neural_Anterior
CAGGATGCAGGTTCAC-1	Neural_Anterior
CAGGCTATCAGGCCTA-1	Neural_Anterior
CAGGCTATCTAGCGAT-1	Neural_Anterior
CAGGCTATCTGTTGCC-1	Neural_Anterior
CAGGCTGGTGTGAGAG-1	Neural_Posterior
CAGGGCTTCAAGCTAC-1	Neural_Posterior
CAGGGTGAGACTTACA-1	Muscle
CAGGGTGAGCTCCCTG-1	Neural_Anterior
CAGGGTGAGGCGAATA-1	Neural_Anterior
CAGGGTGAGGCTAATC-1	Neural_Anterior
CAGGGTGAGGTGTTAC-1	Neural_Posterior
CAGGTCCAGGAGCACG-1	Neural_Posterior
CAGGTGGAGAGGAGGA-1	Neural_Posterior
CAGGTGGAGGCTTAGT-1	Neural_Anterior
CAGGTGGAGTCATGCG-1	Neural_Anterior
CAGGTGGAGTTAGTGC-1	Neural_Anterior
CAGGTTAGTAAATTGC-1	Neural_Anterior
CAGGTTAGTGGAAACG-1	Neural_Posterior
CAGGTTTAGTGAACAG-1	Neural_Anterior
CAGGTTTAGTTCCCAC-1	Neural_Anterior
CAGTACCCAACCGCCA-1	Neural_Anterior
CAGTACCCAATACTGT-1	Neural_Posterior
CAGTACCCACAGGAAT-1	Neural_Anterior
CAGTATGGTTGTAAAC-1	Somites
CATAACGGTAGTAAGA-1	Neural_Posterior
CATAACGGTGAAACAA-1	Neural_Anterior
CATAAGCTCGATATTG-1	Neural_Anterior
CATAAGCTCGCAAACT-1	Neural_Anterior
CATAATCCAATTTGGT-1	Neural_Posterior
CATAATCCACGAATCC-1	Neural_Posterior
CATAGACTCGAGCTAT-1	Neural_Anterior
CATAGACTCTGTGCAG-1	Neural_Posterior
CATAGCTAGTGAGCAA-1	NMPs
CATAGGCGTTGGTTGA-1	Somites
CATAGGTTCAATAGCC-1	Neural_Anterior
CATAGGTTCAGTGAAG-1	Neural_Anterior
CATAGGTTCATTGACA-1	Neural_Anterior
CATAGGTTCGCTAGCA-1	Neural_Anterior
CATAGGTTCGGGCCAT-1	Neural_Posterior
CATAGGTTCTCACAAA-1	Neural_Anterior
CATAGTCAGGATCACT-1	Neural_Anterior
CATAGTCAGGATTTGC-1	Neural_Anterior
CATAGTCAGGCTGTCA-1	Neural_Posterior
CATATCGCACAATTAC-1	Neural_Posterior
CATATCGCAGGCTTGT-1	Neural_Posterior
CATCAATCACACTAAT-1	Neural_Anterior
CATCAATCAGAGGGAG-1	Somites
CATCACACAAGTCGCT-1	Neural_Anterior
CATCACACAATAGCCC-1	Neural_Posterior
CATCACACACACTAAT-1	Neural_Anterior
CATCACACAGGATAAC-1	Neural_Anterior
CATCAGCCAAACGGGC-1	Neural_Anterior
CATCAGCCAGATTCAT-1	Neural_Anterior
CATCAGCCAGGTTATT-1	Neural_Posterior
CATCAGCCAGTTTGGC-1	Muscle
CATCAGCCATAACGGG-1	Neural_Posterior
CATCATGCAATAGCCC-1	Neural_Anterior
CATCATGCAGGCGAGT-1	Neural_Anterior
CATCATGCATTGGGAG-1	Neural_Anterior
CATCCCAGTCCCGAAG-1	Neural_Anterior
CATCCTCAGAATGACG-1	Neural_Posterior
CATCCTCAGCACGATT-1	Neural_Posterior
CATCCTCAGCACGTTG-1	Neural_Posterior
CATCCTCAGGACGTAA-1	Neural_Anterior
CATCCTCAGGTGTTAC-1	Neural_Anterior
CATCCTCAGTGAACAG-1	Neural_Anterior
CATCCTGGTAATCGCA-1	Neural_Posterior
CATCCTGGTCATTAGG-1	Neural_Anterior
CATCCTTCACATAGCC-1	Neural_Anterior
CATCGCTTCACCAATA-1	Neural_Anterior
CATCGCTTCATTGCAA-1	Neural_Posterior
CATCGCTTCCCTGACT-1	Neural_Anterior
CATCGCTTCTTGCAGG-1	Neural_Anterior
CATGAGGCATAGCTGC-1	Neural_Anterior
CATGCAAGTCGTAATG-1	Neural_Anterior
CATGCATAGTCACTAA-1	Neural_Anterior
CATGCATAGTTCCTCA-1	Neural_Anterior
CATGCGCAGGTGCTGC-1	Somites
CATGCGCAGTTAACCA-1	Neural_Anterior
CATGCGCAGTTGGGCC-1	Neural_Posterior
CATGCGGGTGGTTATG-1	Neural_Anterior
CATGCGGGTTCACCAT-1	Neural_Posterior
CATGCGGGTTCGGGAT-1	Neural_Anterior
CATGGATTCATAATCG-1	Neural_Anterior
CATGGATTCTATTGTC-1	Neural_Posterior
CATGGCGGTGAGGTGA-1	Neural_Anterior
CATGGCGGTTGAATCG-1	Neural_Posterior
CATGGCGGTTTGGCGG-1	Neural_Anterior
CATTATCTCGCCTAAG-1	Neural_Anterior
CATTATGAGGTTACGT-1	Neural_Anterior
CATTCATTCCTAGTTT-1	Neural_Posterior
CATTCCTCAATAATCC-1	Neural_Anterior
CATTCCTCACTAAGAA-1	Neural_Anterior
CATTCCTCAGTATGTT-1	Neural_Posterior
CATTGCGAGACAGGTA-1	Neural_Posterior
CATTGCGAGCCGCAAC-1	Neural_Posterior
CATTGCGAGTTATCTC-1	Neural_Posterior
CATTGTAAGCAACAAG-1	Neural_Anterior
CATTGTGCAAACTGTT-1	Muscle
CATTGTGCAGCAATAA-1	Neural_Posterior
CATTGTGCATTATGAC-1	Neural_Anterior
CATTGTGCATTTAAGC-1	Neural_Anterior
CATTTGTTCATTACGA-1	Neural_Anterior
CATTTGTTCCCTCAAC-1	Neural_Posterior
CATTTGTTCGATAACC-1	Neural_Posterior
CATTTGTTCTTAGCCC-1	Neural_Anterior
CATTTGTTCTTCAATC-1	Neural_Anterior
CCAAACCCAACTGGGA-1	Neural_Posterior
CCAAACCCACATAGCC-1	Somites
CCAAACCCAGGAACCA-1	Neural_Anterior
CCAAACTAGCTCCTTA-1	Neural_Anterior
CCAAACTAGCTGGCTA-1	Neural_Anterior
CCAAACTAGGACGTAA-1	Neural_Posterior
CCAAATCAGATTGAGG-1	Neural_Posterior
CCAAATCAGGAGGACT-1	Neural_Posterior
CCAAATCAGGTGTCCA-1	Somites
CCAACCAAGTAGCGCC-1	Neural_Anterior
CCAACCAAGTCCTGAG-1	Neural_Anterior
CCAACCAAGTTACTTC-1	Neural_Anterior
CCAACCCGTTCACTGT-1	Neural_Posterior
CCAACCCGTTGAAGCC-1	Neural_Posterior
CCAAGGCTCATGCTAA-1	Neural_Posterior
CCAAGGCTCTATTGTC-1	Neural_Anterior
CCAAGGCTCTTAATGG-1	Somites
CCAAGGCTCTTGCATT-1	Neural_Anterior
CCAAGTTAGAAGCTAG-1	Neural_Posterior
CCAAGTTAGCGATAGA-1	Neural_Anterior
CCAAGTTAGTTTCCTG-1	Neural_Posterior
CCACAATAGCGCTAAT-1	Neural_Posterior
CCACAATAGGCTACTG-1	Neural_Posterior
CCACAATAGGGATGAC-1	Neural_Posterior
CCACAATAGGTGAGAC-1	Muscle
CCACACAAGGTCCTAG-1	Neural_Anterior
CCACACAAGGTTACAC-1	Neural_Anterior
CCACATTGTTAAGGCC-1	Neural_Posterior
CCACATTGTTAGAGGG-1	Neural_Posterior
CCACTTGGTGGAGCAA-1	Neural_Anterior
CCACTTGGTTAAGCGC-1	Neural_Anterior
CCAGACTCAAGGGTTG-1	Neural_Anterior
CCAGACTCACCTATAG-1	Neural_Anterior
CCAGACTCATGGTTAT-1	Neural_Posterior
CCAGACTCATTATGCG-1	Neural_Posterior
CCAGCTAAGCTCCCTG-1	Neural_Posterior
CCAGCTAAGGGACGCA-1	Neural_Posterior
CCAGCTAAGTCCTTCA-1	Neural_Posterior
CCAGCTGCAAACTGTT-1	Neural_Anterior
CCAGCTGCATTGCAGC-1	Neural_Anterior
CCAGGAACACTTAACG-1	Neural_Posterior
CCAGGAACAGCTCATA-1	Neural_Anterior
CCAGGATGTCACAGAC-1	Neural_Posterior
CCAGTTTGTACAAAGA-1	Neural_Anterior
CCAGTTTGTGGTTAGC-1	Neural_Anterior
CCAGTTTGTTGGATCA-1	Neural_Anterior
CCAGTTTGTTTGGTTC-1	Neural_Anterior
CCATAAATCATGCTCC-1	Neural_Anterior
CCATAAATCCAAACAC-1	Neural_Anterior
CCATAAATCCTTGCAC-1	Neural_Anterior
CCATAAATCGACCTGA-1	Neural_Posterior
CCATAAATCTTTAAGG-1	Neural_Posterior
CCATAAGGTTGTGATG-1	Neural_Anterior
CCATAAGGTTTGCAGA-1	Neural_Posterior
CCATAATCACGTAATT-1	Neural_Anterior
CCATAGCCAATTAAGG-1	Muscle
CCATAGCCAGCCAGTT-1	Neural_Anterior
CCATATTTCAATTGGC-1	Neural_Anterior
CCATATTTCGCTTGCT-1	Neural_Posterior
CCATCACTCATTACAG-1	Neural_Posterior
CCATCACTCCCGTTAC-1	Neural_Anterior
CCATCACTCCTTAATC-1	Neural_Posterior
CCATCACTCGACAAAG-1	Neural_Anterior
CCATCACTCGCGCTAA-1	Neural_Anterior
CCATCACTCGTTAGCG-1	Neural_Posterior
CCATCACTCTAGCGTG-1	Neural_Anterior
CCATCATGTCTTGCTG-1	Neural_Anterior
CCATCATGTGAACAAA-1	NMPs
CCATCATGTGATTACG-1	Neural_Anterior
CCATTATTCAGTTCCC-1	Neural_Anterior
CCATTGTGTAGCTAAT-1	Neural_Anterior
CCCAAACCAAATTGCT-1	Neural_Anterior
CCCAAATAGAGCCGGA-1	Neural_Anterior
CCCAAATAGCGCTCAA-1	Neural_Anterior
CCCAAATAGGCTAATC-1	Neural_Posterior
CCCAACCGTCTTTATG-1	Neural_Anterior
CCCAACCGTGGATGTC-1	Neural_Posterior
CCCAACCGTTTAGTCC-1	Neural_Posterior
CCCAATTGTTAGCTGA-1	Neural_Anterior
CCCAATTGTTGCACAA-1	Neural_Anterior
CCCAATTGTTTCGCCA-1	Neural_Posterior
CCCAGCACAACAGCCT-1	Neural_Anterior
CCCAGCACAAGCTAAA-1	Neural_Anterior
CCCAGCACAAGGATTA-1	Neural_Posterior
CCCAGCACATCCAGGT-1	Neural_Posterior
CCCAGCACATTGTCAG-1	Neural_Anterior
CCCAGTTTCGTAATCA-1	Neural_Posterior
CCCAGTTTCTAGCGTG-1	Neural_Anterior
CCCGCAACAGGTATTT-1	Neural_Anterior
CCCGCAACATAGACCC-1	Muscle
CCCGCTTCAACAACAA-1	Neural_Anterior
CCCGCTTCAGGAATCG-1	Somites
CCCGCTTCAGGTATTT-1	Neural_Anterior
CCCGCTTCATGAATCT-1	Neural_Anterior
CCCGCTTCATGTCAAT-1	Neural_Anterior
CCCGTAAAGCGGCTGT-1	Neural_Posterior
CCCGTAAAGCTAATTG-1	Neural_Anterior
CCCGTAAAGGGACTAA-1	Neural_Anterior
CCCGTAAAGTCCTTTG-1	Neural_Posterior
CCCGTTGTCACCATTT-1	Neural_Anterior
CCCGTTGTCATTACGA-1	Neural_Posterior
CCCGTTGTCCAACTGG-1	Neural_Anterior
CCCGTTGTCCCTGTTA-1	Neural_Posterior
CCCGTTGTCCTAATTC-1	Neural_Anterior
CCCGTTGTCCTAGTAA-1	Neural_Anterior
CCCTAATGTAGTTACG-1	Neural_Anterior
CCCTCACCATTGCAGC-1	Neural_Anterior
CCCTCAGTCCTACCTA-1	Neural_Posterior
CCCTCAGTCCTGAATA-1	Muscle
CCCTCAGTCCTTCAAT-1	Neural_Anterior
CCCTCAGTCGCATCCT-1	Neural_Posterior
CCCTCAGTCGGGCCAT-1	Neural_Anterior
CCCTCATAGCCATCAG-1	Neural_Posterior
CCCTCATAGCTTGCTC-1	Neural_Posterior
CCCTCATAGCTTTGGG-1	Neural_Posterior
CCCTCATAGGGCCACT-1	Neural_Posterior
CCCTGGACACCCACAG-1	Neural_Posterior
CCCTGGACAGAAACGT-1	Neural_Posterior
CCCTGTTAGCGAGGTG-1	Neural_Anterior
CCCTGTTAGTTACCGG-1	Neural_Posterior
CCCTTAATCGGGACTC-1	Neural_Anterior
CCGACAGGTTAATGCG-1	Neural_Posterior
CCGATGCAGAAACTGG-1	Neural_Posterior
CCGCAAATCCGGGACT-1	Neural_Posterior
CCGCAAATCTTAGCGG-1	Neural_Anterior
CCGCAAGGTACCGTTT-1	Neural_Posterior
CCGCAAGGTATTACCC-1	Neural_Anterior
CCGCAAGGTTAGTTGG-1	Neural_Anterior
CCGCAAGGTTCGGGAT-1	Neural_Anterior
CCGCAAGGTTTAGCTC-1	Neural_Anterior
CCGCAAGGTTTCGCGC-1	Neural_Anterior
CCGCACACAAGGTAAC-1	Neural_Posterior
CCGCCAACACGTAATT-1	Somites
CCGCTAGCAACTAGAA-1	Neural_Posterior
CCGCTAGCAAGGTATA-1	Neural_Anterior
CCGCTAGCACCTCACC-1	Neural_Posterior
CCGCTTAGTATTACCC-1	Neural_Posterior
CCGCTTAGTTAGGCGT-1	Neural_Anterior
CCGCTTAGTTCCGGGA-1	Neural_Anterior
CCGCTTAGTTTGGTTC-1	Neural_Posterior
CCGGTAGGTACCGTAA-1	Neural_Anterior
CCGGTAGGTCATAGAT-1	Neural_Posterior
CCGGTAGGTGATCATG-1	Neural_Anterior
CCGGTAGGTTGCACGG-1	Neural_Posterior
CCGGTAGGTTGCGGAT-1	Neural_Anterior
CCGTGCTGTGTAATAC-1	Neural_Anterior
CCGTGCTGTTCCTGAT-1	Neural_Posterior
CCGTGCTGTTGCACAA-1	Somites
CCGTTAACATATAACC-1	Neural_Anterior
CCGTTACTCACTTCAT-1	Neural_Posterior
CCGTTACTCTCGACCT-1	Neural_Posterior
CCGTTATGTAAGGTCC-1	Neural_Anterior
CCGTTATGTAAGTCGC-1	Neural_Anterior
CCGTTATGTTATCCGT-1	Somites
CCGTTATGTTCCGGCT-1	Neural_Anterior
CCGTTGCGTAATAGCT-1	Neural_Anterior
CCGTTGCGTCCCGAAG-1	Neural_Anterior
CCGTTGCGTGTAATAC-1	Neural_Anterior
CCGTTGCGTTTAGCGA-1	Neural_Anterior
CCGTTTGGTAATAACC-1	Neural_Anterior
CCGTTTGGTACCGGAT-1	Neural_Anterior
CCGTTTGGTCATAACG-1	Neural_Anterior
CCGTTTGGTGATGATT-1	Neural_Posterior
CCTAAAGGTAGCTAAT-1	Neural_Posterior
CCTAAAGGTCAGGCCA-1	Neural_Posterior
CCTAAATCAGCACGTT-1	Neural_Anterior
CCTAAATCATTAGGCC-1	Neural_Anterior
CCTAAGCCACAGGATG-1	Neural_Anterior
CCTAAGGTCATTACAG-1	Neural_Posterior
CCTAAGGTCCCGAACA-1	Neural_Posterior
CCTAAGGTCCGCCTAT-1	Neural_Anterior
CCTAAGGTCGTTATCT-1	Neural_Posterior
CCTAAGTAGCTTAACA-1	Neural_Posterior
CCTAATCGTAAAGCGG-1	Neural_Posterior
CCTAATCGTCTAGCTT-1	Neural_Anterior
CCTAATCGTTGAATCG-1	Neural_Anterior
CCTAATCGTTTGCTGT-1	Neural_Posterior
CCTACTGGTCATCATC-1	Neural_Anterior
CCTACTGGTGCTAGAC-1	Neural_Posterior
CCTACTGGTGGATTAT-1	Neural_Anterior
CCTACTGGTGTAACCA-1	Neural_Posterior
CCTACTGGTTCCTGTG-1	Neural_Anterior
CCTACTGGTTGCGGAT-1	Neural_Posterior
CCTACTTCACCTACTT-1	Neural_Anterior
CCTACTTCAGGATTAA-1	Neural_Anterior
CCTACTTCATGTCGCG-1	Neural_Anterior
CCTAGTTGTCATCATC-1	Neural_Posterior
CCTAGTTGTGCTCACC-1	Neural_Posterior
CCTATAGCAACAGCCT-1	Neural_Anterior
CCTATATTCCCATAGG-1	Neural_Anterior
CCTATTGTCATTACTC-1	Somites
CCTATTGTCCCATAGG-1	Neural_Posterior
CCTATTTAGGCATTGT-1	Somites
CCTCAAACAGAACCGA-1	Neural_Anterior
CCTCAAACAGGCGAGT-1	Neural_Anterior
CCTCAAACATAAGCAA-1	Neural_Posterior
CCTCAATGTCCCGGAA-1	Neural_Anterior
CCTCAATGTGTGTGGT-1	Neural_Anterior
CCTCAATGTGTTGTGA-1	Neural_Anterior
CCTCAATGTTAGCATG-1	Neural_Posterior
CCTCAATGTTGCACAA-1	Neural_Posterior
CCTCAGTTCATCCTCA-1	Neural_Anterior
CCTCAGTTCATGAGCT-1	Neural_Posterior
CCTCAGTTCCAAATCA-1	Neural_Posterior
CCTCCTCTCACCTGTC-1	Neural_Anterior
CCTCCTCTCATGCTTT-1	Neural_Posterior
CCTCCTCTCCACCTGT-1	Neural_Anterior
CCTCCTCTCCTTAATC-1	Neural_Anterior
CCTCCTGAGGACCTCA-1	Neural_Anterior
CCTCCTGAGGACTTAC-1	Neural_Anterior
CCTCCTGAGGGATGAC-1	Neural_Anterior
CCTCCTGAGGGCTTTG-1	Neural_Posterior
CCTCCTGAGTTTAACG-1	Neural_Posterior
CCTGAATAGCTGTACG-1	Neural_Posterior
CCTGAATAGGACTAAG-1	Neural_Posterior
CCTGAATAGTTTGGGT-1	Neural_Posterior
CCTGACTTCGTTAACA-1	Neural_Posterior
CCTGAGTCAAGGAATC-1	Neural_Posterior
CCTGAGTCAATGCCTA-1	Neural_Posterior
CCTGAGTCACAGACTC-1	Neural_Posterior
CCTGAGTCAGGTCCTG-1	Neural_Anterior
CCTGATGAGACACCGC-1	Neural_Anterior
CCTGATGAGCCGCTTT-1	Neural_Anterior
CCTGATGAGGCTAAGA-1	Neural_Anterior
CCTGCTCCAATAGTCT-1	Somites
CCTGCTCCATAGCGGA-1	Neural_Posterior
CCTGCTCCATTAGGCC-1	Neural_Posterior
CCTGGATCAAATATCC-1	Neural_Posterior
CCTGTAACACCGTTCC-1	Neural_Anterior
CCTGTAACAGCATGGA-1	Neural_Posterior
CCTGTAACAGCCTTGG-1	Neural_Posterior
CCTGTTGGTCGACTAA-1	Neural_Anterior
CCTGTTGGTTCCAGGG-1	Neural_Posterior
CCTGTTGGTTGCGGAT-1	Neural_Posterior
CCTTAACGTTTATGGG-1	Neural_Posterior
CCTTAACGTTTGGGTA-1	Neural_Posterior
CCTTACTCACCTAATG-1	Neural_Anterior
CCTTACTCACTTCATC-1	Neural_Anterior
CCTTACTCAGCATTAT-1	Neural_Posterior
CCTTACTCATTCCTGT-1	Neural_Anterior
CCTTAGTGTAACAGGG-1	Neural_Posterior
CCTTAGTGTTATTGCC-1	Neural_Anterior
CCTTATGTCACGTTAA-1	Neural_Anterior
CCTTATGTCCATAATG-1	Neural_Anterior
CCTTATGTCTATCGCC-1	Neural_Anterior
CCTTATGTCTTAGCCC-1	Neural_Anterior
CCTTCAATCGGCCATA-1	Neural_Anterior
CCTTCAATCGTGCTAG-1	Neural_Posterior
CCTTCAATCTTGCAAA-1	Neural_Posterior
CCTTCAGGTACTGAAT-1	Neural_Posterior
CCTTCAGGTCATCAAG-1	Neural_Anterior
CCTTCGGTCATCACTT-1	Neural_Anterior
CCTTCGGTCGAAGTAG-1	Neural_Posterior
CCTTCGTAGAGGATAT-1	Neural_Posterior
CCTTCGTAGCATGTCG-1	Neural_Anterior
CCTTCGTAGGCAGGTG-1	Neural_Anterior
CCTTCGTAGGCGGGTA-1	Neural_Anterior
CCTTGCGTCTTAATGG-1	Neural_Posterior
CCTTGCGTCTTTAGGA-1	Neural_Anterior
CCTTTAGTCGTTAGCG-1	Neural_Posterior
CGAAATGAGAAGCTAG-1	Neural_Anterior
CGAAATGAGCGGGCAA-1	Neural_Anterior
CGAAATGAGTATTGCA-1	Neural_Anterior
CGAACAAAGTAAACCC-1	Neural_Anterior
CGAACAAAGTCATCCC-1	Neural_Posterior
CGAAGAATCCCGTTGT-1	Neural_Anterior
CGAAGAATCTACCTAT-1	Neural_Posterior
CGAAGCCTCCTAAGAC-1	Neural_Posterior
CGAAGCCTCGAAGTGA-1	Neural_Anterior
CGAAGCCTCGCATTAA-1	Neural_Posterior
CGAAGCGAGGTAAGGC-1	Neural_Anterior
CGAAGGCCAACAACAA-1	Neural_Posterior
CGAAGGCCAGGTATTT-1	Neural_Anterior
CGAAGTAAGGGATGCG-1	Neural_Anterior
CGAAGTAAGTAAGTGG-1	Neural_Posterior
CGAAGTAAGTAGCGCC-1	Neural_Anterior
CGAATATGTCCACAAA-1	Neural_Posterior
CGAATATGTTGAATCG-1	Neural_Posterior
CGAATATGTTGGATCA-1	Neural_Posterior
CGAATCTAGACAAACG-1	Neural_Anterior
CGACAAGCAGCGCTTG-1	Neural_Anterior
CGACCTGCAAGCGAGC-1	Neural_Posterior
CGACCTGCAGCATTAT-1	Neural_Anterior
CGACCTGCAGGGAGGA-1	Somites
CGACCTGCAGTACCGT-1	Neural_Posterior
CGACCTGCATATAACC-1	Neural_Posterior
CGACCTGCATGTTGTG-1	Neural_Anterior
CGACTAAGTACGCGCA-1	Neural_Anterior
CGACTAAGTCCTTCAG-1	Neural_Anterior
CGAGCGAAGCTATTGA-1	Neural_Anterior
CGAGCGAAGGGCCACT-1	Neural_Posterior
CGAGCGAAGTGAGAGC-1	Neural_Anterior
CGAGCTGGTGCGCGTA-1	unassigned
CGAGCTGGTGCTGGTG-1	Neural_Anterior
CGAGCTGGTGGAGCAA-1	Neural_Anterior
CGAGCTGGTTATCCTA-1	Neural_Posterior
CGAGGAAGTTCCGGGA-1	Neural_Anterior
CGAGGCAAGAGAGGCT-1	Neural_Posterior
CGAGGCAAGGACCAGG-1	Neural_Anterior
CGAGGCAAGGATCCGC-1	Neural_Anterior
CGAGGCAAGGGATTAG-1	Somites
CGAGGCAAGTAACCAC-1	Neural_Anterior
CGAGGCAAGTGAGGTA-1	Neural_Anterior
CGAGGTGAGGAAGCAC-1	Neural_Anterior
CGAGGTGAGGTTACAC-1	Neural_Anterior
CGAGGTGAGTCTATGA-1	Muscle
CGAGTCGGTCACGGAT-1	Neural_Anterior
CGATATTCAATTTGGT-1	Neural_Anterior
CGATATTCAGTAGGTG-1	Neural_Anterior
CGATATTCATAGCGAG-1	Neural_Anterior
CGATCCTTCAGGCTAT-1	Neural_Anterior
CGATGTCCAACTAGCC-1	Muscle
CGATGTCCACTTCATC-1	Neural_Anterior
CGATGTCCAGAGGGAG-1	Neural_Anterior
CGATGTCCAGGCTACT-1	Neural_Anterior
CGATGTCCATTAGGTT-1	Neural_Anterior
CGATTATCAGTAATAG-1	Neural_Anterior
CGATTCCTCCAAATCA-1	Neural_Anterior
CGATTCCTCGATTCTT-1	Neural_Posterior
CGATTCCTCTAAGTGC-1	Neural_Anterior
CGATTGAGTAGGTGTC-1	Neural_Anterior
CGATTGAGTTGAATCG-1	Neural_Anterior
CGATTGAGTTGGATAT-1	Neural_Anterior
CGATTTGCAAGCTAAA-1	Neural_Anterior
CGCAAATTCAACCAAC-1	Neural_Posterior
CGCAAATTCAGGAAGC-1	Neural_Posterior
CGCAATAGTAATCGGC-1	Neural_Anterior
CGCAATAGTATTTGGG-1	Neural_Anterior
CGCAATAGTGTCCTGC-1	Neural_Posterior
CGCAATCCAGCTCAAC-1	Neural_Anterior
CGCAATCCATTGTGGC-1	Neural_Posterior
CGCAATGTCTTAGCGG-1	Neural_Posterior
CGCAATTAGGTATTGC-1	Neural_Anterior
CGCAATTAGTCTTGAA-1	Neural_Anterior
CGCACAATCGATAACC-1	Neural_Anterior
CGCACAATCTAACCAA-1	Neural_Anterior
CGCACACAGAGAGCCG-1	Neural_Posterior
CGCACCACAATAACGA-1	Neural_Anterior
CGCACCACAGACAAAC-1	Neural_Posterior
CGCACCACATGCTCCC-1	Neural_Anterior
CGCATGATCTCCTCTT-1	Neural_Anterior
CGCATTACAATCTCTC-1	Neural_Posterior
CGCATTACAGGAATCG-1	Neural_Anterior
CGCATTTGTAACGGGA-1	Neural_Posterior
CGCATTTGTGACCTGG-1	Neural_Posterior
CGCATTTGTTCGGTAA-1	Neural_Anterior
CGCATTTGTTTGCGCC-1	Neural_Anterior
CGCCAAATCTCGCCTG-1	Neural_Posterior
CGCCACACACAAAGAC-1	Neural_Anterior
CGCCACACACTCGCTC-1	Neural_Anterior
CGCCTCATCCCGCATT-1	Neural_Anterior
CGCCTGTGTAATCCCT-1	Neural_Anterior
CGCCTGTGTTAGGCTA-1	Neural_Anterior
CGCGATTCAGTACCGT-1	Neural_Posterior
CGCGGATTCAGTATTG-1	Neural_Anterior
CGCGGATTCCAGGGAG-1	Neural_Anterior
CGCGGATTCTATCGCC-1	Muscle
CGCTAACCAAGGTACG-1	Neural_Anterior
CGCTAACCAGTTAAAG-1	Neural_Posterior
CGCTAATAGCTGGAAA-1	Neural_Anterior
CGCTAATAGCTTTGGG-1	Neural_Anterior
CGCTAATAGGTCCGTA-1	Neural_Anterior
CGCTACTTCATTGTCT-1	Neural_Posterior
CGCTACTTCCAAGTTA-1	Neural_Anterior
CGCTACTTCGTTCACC-1	Neural_Posterior
CGCTATGAGATGGACA-1	Neural_Anterior
CGCTATGAGCGCTCAA-1	Neural_Anterior
CGCTATGAGGCGGATG-1	Neural_Anterior
CGCTCAGCAAGTGAAC-1	Neural_Posterior
CGCTCAGCACTAGCGT-1	Neural_Posterior
CGCTCAGCAGCATTAT-1	Neural_Anterior
CGCTCAGCAGGGAGGA-1	Neural_Anterior
CGCTCAGCAGTAGGTG-1	Neural_Posterior
CGCTCCATCACGCGGT-1	Muscle
CGCTCCATCATAGCCG-1	Neural_Anterior
CGCTGTGCAACACTTG-1	Neural_Anterior
CGCTTACTCACAGACT-1	Neural_Posterior
CGCTTACTCCCTCGCA-1	Neural_Anterior
CGCTTACTCGGCCAGT-1	Neural_Posterior
CGCTTCTAGCTTCTCA-1	Neural_Anterior
CGCTTCTAGGCAAGTA-1	Neural_Anterior
CGCTTCTAGTTAGACC-1	Neural_Posterior
CGCTTGCGTCTTGCTG-1	Neural_Posterior
CGCTTGCGTTGCGCGA-1	Neural_Posterior
CGGAATCGTAATGACT-1	Neural_Anterior
CGGAATCGTCATTGTC-1	Neural_Anterior
CGGACAACAAACGGGC-1	Neural_Anterior
CGGACAACAAGTGAAC-1	Neural_Anterior
CGGACAACACTTAACG-1	Neural_Posterior
CGGACAACAGGCGAGT-1	Muscle
CGGACCTAGATTCCTT-1	Neural_Anterior
CGGACCTAGTCAGTAC-1	Neural_Anterior
CGGACCTAGTTGCGTG-1	Neural_Anterior
CGGAGCAAGCAAGGTA-1	Neural_Posterior
CGGAGCAAGGCAGGTG-1	Neural_Posterior
CGGAGCAAGTCCTTTG-1	Neural_Anterior
CGGAGTCTCGGCCATA-1	Neural_Posterior
CGGAGTCTCGTTATAG-1	Neural_Anterior
CGGATAAAGAGGGACT-1	Neural_Posterior
CGGATAAAGCTGTACG-1	Neural_Anterior
CGGATAAAGTAGCGGG-1	Neural_Posterior
CGGATTAGTAAGGTTT-1	Neural_Anterior
CGGATTAGTAATTAGC-1	Neural_Posterior
CGGCAATGTAACGTGC-1	Neural_Anterior
CGGCAATGTAAGCTTG-1	Somites
CGGCCATAGCTCCTAC-1	Neural_Posterior
CGGCTAATCGAGCTAT-1	Neural_Posterior
CGGCTAATCGGTTTCC-1	Neural_Posterior
CGGCTAATCGTAATCA-1	Neural_Anterior
CGGCTAATCTAACTGA-1	Neural_Posterior
CGGCTAATCTCGCCTG-1	Somites
CGGCTCACACCATATG-1	Neural_Posterior
CGGCTCACATCGTTCT-1	Neural_Anterior
CGGGACAAGGCTACAT-1	Neural_Posterior
CGGGACAAGGGACCTC-1	Neural_Posterior
CGGGACAAGTTAGAGG-1	Neural_Posterior
CGGGACAAGTTGTCAA-1	Neural_Anterior
CGGGCTTAGCATGAAG-1	Neural_Posterior
CGGGTCTAGCCTGGTA-1	Neural_Anterior
CGGGTCTAGGCCTGGT-1	Neural_Posterior
CGGGTCTAGTAAACCC-1	Neural_Anterior
CGGGTCTAGTCATGCG-1	Neural_Posterior
CGGTAACGTTAGGATT-1	Neural_Anterior
CGGTAACGTTATCCTA-1	Neural_Posterior
CGGTAACGTTGGCCGA-1	Neural_Anterior
CGGTGAACACCTAATG-1	Neural_Anterior
CGGTGAACACCTGGTG-1	Neural_Posterior
CGGTGAACAGGCCTTG-1	Neural_Posterior
CGGTGAACAGGTTAAA-1	Neural_Posterior
CGGTGAACATGTCGCG-1	Neural_Anterior
CGGTGAGAGCGGATAA-1	Neural_Anterior
CGGTGAGAGGTTTGCG-1	Neural_Anterior
CGGTGAGAGTATTGCA-1	Neural_Posterior
CGGTGAGAGTCACGAT-1	Neural_Anterior
CGGTTATAGCCTGTGA-1	Neural_Anterior
CGGTTATAGGACCTGC-1	Neural_Anterior
CGGTTATAGGTGTTAC-1	Neural_Anterior
CGGTTCCGTCAATAGT-1	Somites
CGGTTCCGTGCTGGTG-1	Neural_Anterior
CGGTTGGGTAAATTGC-1	Neural_Anterior
CGGTTGGGTGCGCAAT-1	Neural_Anterior
CGGTTTGAGAACCTGT-1	Neural_Posterior
CGGTTTGAGCTTCCCG-1	Neural_Anterior
CGGTTTGAGGAGGCAT-1	Neural_Posterior
CGGTTTGAGTTCCTGC-1	Neural_Posterior
CGTAACCCAATAGCCC-1	Neural_Anterior
CGTAACCCACAAGCCT-1	Neural_Posterior
CGTAACTAGAGAGCCG-1	Somites
CGTAACTAGCTATATG-1	Neural_Anterior
CGTAACTAGGTTAGCT-1	Neural_Posterior
CGTAATGGTCCTTCTC-1	Neural_Anterior
CGTAATGGTCTTGCAT-1	Neural_Posterior
CGTAATGGTGGAAACG-1	Neural_Posterior
CGTAATGGTTGCAATG-1	Neural_Anterior
CGTAATGGTTTGACCT-1	Neural_Anterior
CGTACGGGTCCGTAGG-1	Neural_Anterior
CGTACGGGTTGCTTCG-1	Neural_Posterior
CGTACGGGTTTCCTCC-1	Neural_Anterior
CGTAGCGGTAATGGCC-1	Neural_Anterior
CGTAGCGGTTGTTGCT-1	Neural_Anterior
CGTAGCGGTTTGTCTA-1	Neural_Anterior
CGTAGTTAGCAGGTGG-1	Neural_Posterior
CGTAGTTAGGATCACT-1	Neural_Posterior
CGTAGTTAGTATCGCG-1	Neural_Posterior
CGTCAATAGGAGGTTA-1	Neural_Anterior
CGTCAATAGTAACTCA-1	Neural_Posterior
CGTCATTGTATTGAGT-1	Neural_Anterior
CGTCATTGTCATCCTG-1	Neural_Anterior
CGTCATTGTCCGTGAG-1	Neural_Posterior
CGTCATTGTGTTGTAG-1	Neural_Posterior
CGTCATTGTTCATCTA-1	Neural_Anterior
CGTGACATCCCTCGCA-1	Neural_Anterior
CGTGACATCTAGCTAA-1	Neural_Posterior
CGTGACATCTGTTGCC-1	Neural_Anterior
CGTGACATCTTGACCC-1	Neural_Anterior
CGTGAGGAGCAATAGG-1	Neural_Anterior
CGTGCTGCAACAGCCT-1	Neural_Anterior
CGTGCTGCAAGGACCA-1	Neural_Posterior
CGTGCTGCAGGCTACT-1	Neural_Anterior
CGTGCTTTCATGCGTG-1	Neural_Anterior
CGTGCTTTCGCACACA-1	Neural_Anterior
CGTGCTTTCTTTGACT-1	Neural_Anterior
CGTGGTTCATCAGCAC-1	Neural_Anterior
CGTGTGTCACCTCACC-1	Neural_Posterior
CGTGTTACAAACTGTT-1	Neural_Anterior
CGTGTTACATCGCTTT-1	Neural_Anterior
CGTGTTACATGGCCCA-1	Neural_Anterior
CGTTAAATCGAGCAAA-1	Neural_Anterior
CGTTAAATCTCGCCCA-1	Neural_Posterior
CGTTAACAGCAGGCCT-1	Neural_Anterior
CGTTAACAGGATCACT-1	Neural_Anterior
CGTTAACAGTTGCCTC-1	Neural_Anterior
CGTTAGGTCCTCGATC-1	Neural_Posterior
CGTTAGGTCGCTTGCT-1	Neural_Posterior
CGTTAGGTCGTTAACA-1	Somites
CGTTAGTAGCGAGGTG-1	Neural_Anterior
CGTTAGTAGGCTCATG-1	Neural_Anterior
CGTTAGTAGGTCAAAG-1	Neural_Posterior
CGTTAGTAGTAACGAG-1	Neural_Anterior
CGTTATCGTCACAAAT-1	unassigned
CGTTATCGTGATGGCT-1	Somites
CGTTATCGTGCTTACT-1	Muscle
CGTTATCGTTAGGTGC-1	Neural_Anterior
CGTTATCGTTCCTGAT-1	Muscle
CGTTATTTCCCTCTAA-1	Neural_Anterior
CGTTATTTCCGCTAGA-1	Neural_Anterior
CGTTATTTCGCCTGTT-1	Neural_Posterior
CGTTATTTCTCCATGC-1	Neural_Posterior
CGTTATTTCTTGCATT-1	Neural_Posterior
CGTTGCAAGGCATGAA-1	Neural_Posterior
CGTTGCAAGGTCCGTA-1	Neural_Posterior
CGTTGCAAGTAAACCC-1	Neural_Posterior
CGTTGCGCAAACCTAT-1	Neural_Anterior
CGTTGCGCAACCGCCA-1	Neural_Posterior
CGTTGCGCACCTGTAA-1	Neural_Anterior
CGTTGCGCAGGCTAAG-1	Neural_Anterior
CGTTGCGCAGGCTACT-1	Neural_Posterior
CGTTTGGAGCCGCAAC-1	Neural_Anterior
CGTTTGGAGTGGCGGA-1	Neural_Posterior
CGTTTGGAGTTAGCCG-1	Neural_Posterior
CGTTTGGAGTTTGTCT-1	Neural_Anterior
CGTTTGTGTTTAGTCC-1	Muscle
CTAAAGCTCAAGCCTG-1	Neural_Posterior
CTAAAGCTCAAGTGAG-1	Neural_Anterior
CTAAAGCTCGGTCAGC-1	Neural_Anterior
CTAAAGCTCGTTACTT-1	Neural_Posterior
CTAAATGTCGCTATGG-1	Somites
CTAACCACATAGACTT-1	Neural_Anterior
CTAACCCTCAATAGCC-1	Neural_Anterior
CTAACCCTCAGGCTAT-1	Neural_Posterior
CTAACCCTCCTGTTCA-1	Neural_Anterior
CTAACCTGTTGCACGG-1	Neural_Anterior
CTAACCTGTTGGTTAG-1	Neural_Anterior
CTAACCTGTTGTTGGA-1	Neural_Posterior
CTAAGGTTCATTTAGG-1	Neural_Anterior
CTAAGGTTCTTAGTGA-1	Neural_Posterior
CTAAGTCAGCAAGGAC-1	Neural_Anterior
CTAAGTCAGGTCGATT-1	Neural_Posterior
CTAAGTCAGTCACCAG-1	Neural_Posterior
CTAATAGTCAGCAAAG-1	Neural_Anterior
CTAATAGTCAGCTAAC-1	Neural_Posterior
CTAATAGTCGCAAACT-1	Neural_Posterior
CTAATCCGTCATAAGT-1	Somites
CTAATCCGTTGAAGCC-1	Neural_Posterior
CTAATCCGTTTGCTGT-1	Neural_Posterior
CTAATCGCATAATCGT-1	Neural_Anterior
CTAATCGCATTGCGAC-1	Neural_Posterior
CTAATCTTCGATCAGT-1	Neural_Anterior
CTAATGTCAACTAGAA-1	Neural_Anterior
CTAATGTCACACAATT-1	Neural_Anterior
CTAATGTCAGAAACGT-1	Neural_Anterior
CTAATGTCAGCCTGCA-1	Neural_Posterior
CTAATTGAGCGGGCAA-1	Neural_Posterior
CTAATTGAGGGATGAC-1	Neural_Posterior
CTAATTGAGTCCTTTG-1	Neural_Anterior
CTACAACAGGCGCTTA-1	Neural_Anterior
CTACCGGCATTCCTCG-1	Neural_Posterior
CTACCTCAGAGGATAT-1	Neural_Anterior
CTACCTCAGCGCCTAA-1	Neural_Anterior
CTACGAAGTCATAGAT-1	Neural_Anterior
CTACGAAGTGTGTGGT-1	Somites
CTACTTAGTACGCGCA-1	Neural_Anterior
CTACTTAGTGCCTCAC-1	Neural_Posterior
CTACTTAGTTCTTTAG-1	Neural_Anterior
CTAGATTCAAAGCGCA-1	Somites
CTAGATTCAGCAAGTG-1	Neural_Anterior
CTAGATTCATTGCGAC-1	Neural_Anterior
CTAGCTGAGCATTATG-1	Neural_Anterior
CTAGCTGAGGAGGGTT-1	Neural_Anterior
CTAGCTTGTTTAACCC-1	Neural_Anterior
CTAGCTTGTTTACTTG-1	Neural_Anterior
CTAGGACGTGTTGTAG-1	Neural_Posterior
CTAGGCGGTGATCAGC-1	Neural_Anterior
CTAGTAATCAAGCTTA-1	Neural_Anterior
CTAGTAATCTCACTCA-1	Neural_Anterior
CTAGTAGGTGAGACTC-1	Neural_Anterior
CTAGTCGAGCACAGCC-1	Neural_Posterior
CTAGTCGAGCTTAGCG-1	Neural_Anterior
CTAGTCGAGGAAACTG-1	Neural_Posterior
CTAGTCGAGGAAGCAC-1	Neural_Anterior
CTAGTCGAGTAAGTCC-1	Neural_Anterior
CTAGTGAGTAATGGAA-1	Muscle
CTAGTGAGTACGTTTC-1	Neural_Anterior
CTAGTGAGTCCTAATC-1	Neural_Anterior
CTAGTGAGTGTGTCCC-1	Neural_Anterior
CTAGTTGCACAAGCCT-1	Neural_Posterior
CTAGTTGCACAGGATG-1	Neural_Posterior
CTAGTTGCATGTCAGC-1	Neural_Anterior
CTATAACCAACAGGTG-1	Neural_Posterior
CTATGACAGGAATAAC-1	Neural_Anterior
CTATGACAGGCGGGTA-1	Neural_Anterior
CTATGACAGTGAGAGC-1	Neural_Anterior
CTATGAGGTAGCCTAA-1	Neural_Posterior
CTATGAGGTGAGGTGA-1	Neural_Posterior
CTATGATCATAATCCG-1	Neural_Posterior
CTATGATCATTTGCTC-1	Neural_Anterior
CTATGGCCACGTGCTG-1	Neural_Posterior
CTATGGCCAGCATGAG-1	Neural_Posterior
CTATGGCCAGCTCATA-1	Neural_Anterior
CTATGTTTCATAACTG-1	Neural_Posterior
CTATGTTTCGAGCTAT-1	Neural_Anterior
CTATTACTCATAACTG-1	Neural_Anterior
CTATTACTCCACAATA-1	Neural_Posterior
CTATTACTCTCAATGA-1	Neural_Anterior
CTATTCAGTGCATTTC-1	Neural_Anterior
CTATTCAGTTGTTGGA-1	Neural_Posterior
CTATTGAAGACAACAG-1	Neural_Anterior
CTATTGAAGACTCGCA-1	Neural_Posterior
CTATTGAAGCTGTACG-1	Neural_Posterior
CTATTGAAGGATGATG-1	Neural_Anterior
CTATTGAAGTGAACGA-1	Neural_Posterior
CTCAATAAGACAAAGT-1	Neural_Anterior
CTCAATAAGCCGCTAA-1	Neural_Posterior
CTCAATAAGCGAGTAA-1	Neural_Posterior
CTCAATAAGTTGCGTG-1	Neural_Anterior
CTCACAACATAATCCG-1	Neural_Anterior
CTCACTCAGGTTTGAC-1	Neural_Anterior
CTCAGGATCATGTCAA-1	Neural_Posterior
CTCATCATCAAGCTAC-1	Neural_Posterior
CTCATCATCAATCTCT-1	Neural_Anterior
CTCATCATCATCCTGC-1	Neural_Anterior
CTCATCATCCGGAACC-1	Neural_Anterior
CTCATCATCTCAATGA-1	Neural_Posterior
CTCATCATCTCCTCTT-1	Neural_Anterior
CTCATGACAAGCTAAA-1	Neural_Anterior
CTCATGCTCAATGAGG-1	Neural_Posterior
CTCATGCTCACTTCAT-1	Neural_Posterior
CTCATGCTCAGAAACG-1	Neural_Anterior
CTCATGCTCATTACGA-1	Neural_Anterior
CTCATGCTCTGTGAGT-1	Neural_Posterior
CTCATTAGTTCGGGAT-1	Neural_Posterior
CTCCAAACAATATGGA-1	Somites
CTCCAAACATCCGTAA-1	Neural_Posterior
CTCCAACTCACTAGGT-1	Neural_Posterior
CTCCAACTCCTCATGC-1	Neural_Posterior
CTCCAACTCCTTGCAC-1	Neural_Posterior
CTCCATCAGGTTAGCT-1	Neural_Anterior
CTCCCTGAGCCAGTAT-1	Neural_Anterior
CTCCCTGAGGCAATAG-1	Neural_Posterior
CTCCGGACACGGTACT-1	Neural_Posterior
CTCCGGACACGTGCTG-1	Neural_Anterior
CTCCGGACATACCCGG-1	Neural_Anterior
CTCCGTCCACGAATCC-1	Neural_Posterior
CTCCGTCCATGTCAGC-1	Neural_Posterior
CTCCTAATCACGCCAA-1	Neural_Posterior
CTCCTAATCATAATCG-1	Neural_Posterior
CTCCTAATCATTACTC-1	Neural_Anterior
CTCCTAATCATTCATC-1	Neural_Anterior
CTCCTCACAAACATAG-1	Neural_Posterior
CTCCTCACAATAAGCA-1	Neural_Anterior
CTCCTCACAATAATGG-1	Neural_Anterior
CTCCTCACAATTGAAG-1	Neural_Anterior
CTCCTCACACGTTACA-1	Neural_Posterior
CTCCTCACAGCCTAAC-1	Neural_Anterior
CTCCTGAGTAACCTAG-1	Neural_Posterior
CTCCTGAGTCAAAGAA-1	Neural_Anterior
CTCCTGAGTCCGTAGG-1	Neural_Anterior
CTCCTGAGTTCCTGAT-1	Neural_Posterior
CTCCTGAGTTGGTTGA-1	Neural_Posterior
CTCGCTAGTAACAGGG-1	Neural_Posterior
CTCGCTAGTAACCAGC-1	Neural_Posterior
CTCGCTAGTAATGACT-1	Neural_Posterior
CTCGCTAGTATGTGGC-1	Neural_Anterior
CTCGCTAGTCAACAAT-1	Neural_Anterior
CTCGCTAGTCCACAAA-1	NMPs
CTCGCTAGTGAGCACT-1	Neural_Anterior
CTCGCTAGTTAGAGGG-1	Neural_Anterior
CTCGCTCCAGCAGGTA-1	Neural_Anterior
CTCGCTCCAGTACCGT-1	Neural_Posterior
CTCGCTCCATTGTGAT-1	Neural_Anterior
CTCGTTATCATCACTT-1	Neural_Posterior
CTCGTTATCGCTAAGT-1	Neural_Anterior
CTCTAGCTCAAACCTA-1	Neural_Anterior
CTCTAGCTCTTTAAGG-1	Neural_Anterior
CTCTATGTCATTTGCT-1	Somites
CTCTCACAGGGATGCG-1	Neural_Posterior
CTCTGTTCAAGGCCAA-1	Neural_Anterior
CTCTGTTCAGCGCTTG-1	Neural_Anterior
CTCTGTTCAGGAACTG-1	Neural_Anterior
CTCTTGATCATCACTT-1	Neural_Posterior
CTCTTGATCCTCAGTC-1	Neural_Posterior
CTCTTGATCCTTGTTG-1	Neural_Posterior
CTCTTGATCGCTAGCA-1	Neural_Posterior
CTCTTGATCTTGTTCG-1	Neural_Anterior
CTGAAACTCCAGGGAG-1	Neural_Anterior
CTGAATATCATGCGTG-1	Neural_Anterior
CTGAATATCATGGCCA-1	Neural_Anterior
CTGAATATCCCTCAAC-1	Neural_Posterior
CTGAATATCCTGGTGA-1	Neural_Anterior
CTGAATATCTAACCTT-1	Neural_Anterior
CTGACATAGGCTAAGA-1	Neural_Posterior
CTGACATAGTAACCCG-1	Neural_Anterior
CTGACCAAGCAGGCCT-1	Neural_Anterior
CTGACCAAGCTCGCTT-1	Neural_Anterior
CTGACCAAGGCATGAA-1	Neural_Posterior
CTGACCAAGGGCTTAT-1	Neural_Anterior
CTGATCACAGCATGTC-1	Neural_Anterior
CTGCAATAGGACAACA-1	Neural_Anterior
CTGCAATAGTATTGGC-1	Neural_Posterior
CTGCTACTCTAGCTAA-1	Neural_Anterior
CTGCTATGTAATCCCT-1	Neural_Anterior
CTGCTATGTAATGACT-1	Neural_Anterior
CTGCTATGTACTTAGG-1	Neural_Posterior
CTGCTATGTCTAACCT-1	Neural_Anterior
CTGCTATGTTGTCATC-1	Neural_Posterior
CTGCTATGTTTGAGGC-1	Neural_Anterior
CTGCTCCCAAACTGTT-1	Neural_Anterior
CTGCTCCCAAAGCCTC-1	Neural_Posterior
CTGCTCCCATGGAGGC-1	Neural_Posterior
CTGGACCAGATTCCTT-1	Neural_Anterior
CTGGACCAGTAGCGGG-1	Neural_Posterior
CTGGACCAGTCTTGAA-1	Neural_Anterior
CTGGACCAGTTTCCTG-1	Neural_Anterior
CTGGATGTCTAAGTGC-1	Neural_Anterior
CTGGCTAAGGAACGCG-1	Neural_Posterior
CTGGCTAAGGACCTTG-1	Neural_Anterior
CTGGCTAAGTCCTGAG-1	NMPs
CTGGCTTTCTTGACCC-1	Neural_Posterior
CTGGTAAGTAATGGAA-1	Neural_Posterior
CTGGTAAGTCCAAGAC-1	Neural_Posterior
CTGGTAAGTCTTGCTG-1	Somites
CTGGTCAAGGCAACAA-1	Neural_Posterior
CTGGTCAAGTAAGTCC-1	Neural_Anterior
CTGGTCAAGTAGAGGC-1	Neural_Posterior
CTGGTTACAATTTGGT-1	Neural_Anterior
CTGGTTTGTAGCTAGC-1	Neural_Anterior
CTGTAACAGGTTACGT-1	Neural_Anterior
CTGTAACAGTTGGGCC-1	Neural_Anterior
CTGTACCTCACCTGTC-1	Neural_Anterior
CTGTACCTCCAGGGAG-1	Neural_Posterior
CTGTACCTCCGCAAGC-1	Neural_Posterior
CTGTATTTCATTGACA-1	Neural_Posterior
CTGTATTTCCCTCACG-1	Neural_Anterior
CTGTATTTCGCAACAT-1	Neural_Posterior
CTGTATTTCTAAGTCA-1	Neural_Anterior
CTGTGTGAGCCTCTGT-1	Neural_Posterior
CTGTGTGAGGCAGGTG-1	Neural_Anterior
CTGTTAAAGGAGCATA-1	unassigned
CTGTTAAAGGCCCAGT-1	NMPs
CTGTTAAAGGGTCTAT-1	Neural_Anterior
CTGTTAAAGGTCCGTA-1	Neural_Anterior
CTGTTAAAGTAGGCGG-1	Neural_Anterior
CTGTTCATCTTGTTCG-1	Neural_Anterior
CTGTTGGAGAAGGTGC-1	Neural_Posterior
CTGTTGGAGCAAGGAC-1	Neural_Posterior
CTGTTGGAGGTAGCTT-1	Neural_Anterior
CTGTTTAGTACGATTG-1	Neural_Anterior
CTGTTTAGTCACCTAT-1	Neural_Posterior
CTGTTTAGTGCTCACC-1	Neural_Anterior
CTTAACAAGCCAAATC-1	Neural_Anterior
CTTAACAAGCCTGAGC-1	Neural_Anterior
CTTAACAAGGACCTCA-1	Somites
CTTAAGGGTAGACAAA-1	Somites
CTTAAGGGTCATGCCC-1	Somites
CTTAAGGGTTAACGAT-1	Neural_Anterior
CTTAAGGGTTGGTTAG-1	Neural_Anterior
CTTACCGGTAAGCACC-1	Neural_Posterior
CTTACCGGTCAAGTGC-1	Neural_Posterior
CTTACCTCAAGCTAAA-1	Neural_Anterior
CTTACTAGTTTAACCC-1	Neural_Anterior
CTTAGGAGTGATGGCT-1	Neural_Anterior
CTTAGGAGTGCTTACT-1	Neural_Anterior
CTTAGGAGTTGGTTGA-1	Neural_Anterior
CTTAGGAGTTTCCTCC-1	Neural_Anterior
CTTAGTTTCTCCTCTT-1	Neural_Posterior
CTTATGTTCCCGAACA-1	Neural_Posterior
CTTATGTTCGTAACGT-1	Neural_Anterior
CTTATGTTCTCGCCTG-1	Neural_Anterior
CTTATTGGTTATTGCC-1	Neural_Anterior
CTTCAATTCAATTGGC-1	Neural_Anterior
CTTCAATTCACCATTT-1	Neural_Anterior
CTTCAATTCCTCGATC-1	Somites
CTTCACTCAAACGCGA-1	Neural_Anterior
CTTCAGGAGGAGGACT-1	Neural_Posterior
CTTCAGGAGGCACAGG-1	Neural_Anterior
CTTCAGGAGGTATTGC-1	Neural_Anterior
CTTCAGGAGTGAACCT-1	Neural_Posterior
CTTCATCCAACAGCCT-1	Neural_Anterior
CTTCATCCAAGGTCCT-1	Muscle
CTTCATCCAGCAAGAT-1	Neural_Posterior
CTTCGCGTCGTTATCT-1	Neural_Posterior
CTTCTAAGTCGTAATG-1	Neural_Anterior
CTTCTAAGTGTTAGCA-1	Neural_Anterior
CTTCTAAGTGTTTCAC-1	Neural_Anterior
CTTCTCAAGCCTCTGT-1	Neural_Anterior
CTTCTCAAGGAAGCTA-1	Neural_Posterior
CTTCTCAAGGAGCATA-1	Neural_Posterior
CTTCTCAAGGTGAAAT-1	Neural_Anterior
CTTCTCAAGTACTGGT-1	Neural_Posterior
CTTCTCAAGTCAGTAC-1	Neural_Anterior
CTTGAACAGCGATAGA-1	Neural_Posterior
CTTGAACAGGGCTTAT-1	Neural_Anterior
CTTGAACAGGTTACGT-1	Neural_Anterior
CTTGAATCAAGCTTAT-1	Neural_Posterior
CTTGAATCAAGTTATC-1	Neural_Anterior
CTTGAATCACTAGCGT-1	Neural_Anterior
CTTGAATCAGCACGTT-1	Neural_Anterior
CTTGAATCATCAATCG-1	Neural_Anterior
CTTGCAACAATTAGCT-1	Neural_Anterior
CTTGCAACATGCTTAG-1	Neural_Posterior
CTTGCATGTGGTTCCC-1	Neural_Posterior
CTTGCATGTGTTTGAG-1	Neural_Anterior
CTTGCATGTTGTTGCT-1	Neural_Posterior
CTTGCATGTTTGCGAA-1	Neural_Anterior
CTTGCGCGTAAACAAG-1	Neural_Posterior
CTTGCGCGTCATTGTC-1	Neural_Posterior
CTTGCGCGTGGTTAGC-1	Neural_Anterior
CTTGCGCGTTAGCCAA-1	Neural_Posterior
CTTGCGCGTTATAGCG-1	Muscle
CTTGCGCGTTTACTTG-1	Neural_Anterior
CTTGCGCGTTTAGCTC-1	Neural_Anterior
CTTGCGCGTTTATCTG-1	Neural_Posterior
CTTGCTCAGGTGAAAT-1	Neural_Anterior
CTTGTAAAGCTCAAAC-1	Neural_Posterior
CTTGTAAAGCTGTAAC-1	Neural_Anterior
CTTGTAAAGGAACCGG-1	Neural_Anterior
CTTGTAAAGGATAAAC-1	Muscle
CTTGTAAAGTATTGTG-1	Neural_Posterior
CTTGTAAAGTTTGCGG-1	Neural_Anterior
CTTGTCCAGCCAGTAT-1	Neural_Anterior
CTTGTTCCAAAGGCCA-1	Neural_Anterior
CTTGTTCCAACTCGCG-1	Neural_Posterior
CTTGTTCCACCTGCTC-1	Neural_Anterior
CTTGTTCCACGTGCTG-1	Neural_Anterior
CTTGTTTAGGATTGCT-1	Neural_Posterior
CTTGTTTAGTAACTCA-1	Neural_Anterior
CTTTAGGCAAGGGTTG-1	Neural_Anterior
CTTTAGGCACCTACTT-1	Muscle
CTTTAGGCATGTCAAT-1	Neural_Posterior
CTTTATCAGCACTAAC-1	Neural_Anterior
CTTTATCAGGACACTT-1	Neural_Anterior
CTTTATGGTCCTTCTC-1	Neural_Anterior
CTTTATGGTCTATCGT-1	Somites
CTTTATGGTTATGTGG-1	Neural_Anterior
CTTTCTTGTAAGGTTT-1	Neural_Posterior
CTTTGAGCAATGAATG-1	Neural_Posterior
CTTTGAGCAGCTTAAT-1	Neural_Anterior
CTTTGAGCATCTAGCA-1	Muscle
CTTTGAGCATCTTGAG-1	Neural_Anterior
CTTTGGGAGCAAACCT-1	Neural_Posterior
CTTTGGGAGCATGAAG-1	Neural_Anterior
CTTTGGGAGGAGGGTT-1	Neural_Posterior
CTTTGGGAGTGAAGTG-1	Neural_Posterior
CTTTGGTGTCACCAAA-1	Neural_Anterior
CTTTGGTGTCATAACG-1	Neural_Anterior
CTTTGGTGTGGGTGAA-1	Neural_Posterior
CTTTGGTGTTACGCAA-1	Neural_Anterior
CTTTGTCCAACTAGAA-1	Somites
CTTTGTCCAAGGTGGC-1	Neural_Anterior
CTTTGTCCACTAGCGT-1	Neural_Anterior
CTTTGTCCACTTCATC-1	Neural_Anterior
GAAACCCGTACGCGCA-1	Neural_Posterior
GAAACCCGTCCTTTAA-1	Neural_Anterior
GAAACCCGTCTTTGAC-1	Neural_Anterior
GAAACCCGTTGCGCGA-1	Neural_Anterior
GAAACTGAGAGCCGGA-1	Neural_Posterior
GAAACTGAGCACGTTG-1	Neural_Anterior
GAAACTGAGGAACCGG-1	Neural_Posterior
GAAAGCCAGCAACATC-1	Neural_Posterior
GAAAGCCAGGCTTAGT-1	Neural_Anterior
GAAAGCCAGGTACCGC-1	Neural_Anterior
GAAAGCCAGGTCCTAG-1	Neural_Anterior
GAAAGGCTCCGCCAAA-1	Neural_Anterior
GAACACAAGCAAGGTA-1	Neural_Posterior
GAACACAAGCATGACT-1	Neural_Anterior
GAACACAAGCTAATCA-1	Neural_Posterior
GAACACAAGGCCGGAA-1	Neural_Anterior
GAACCAAAGACAAAGT-1	Neural_Anterior
GAACCAAAGATGCCTG-1	Neural_Posterior
GAACCAGCAAAGCTCC-1	Neural_Anterior
GAACCAGCAAAGGTAC-1	Neural_Anterior
GAACCAGCAGGCGATA-1	Neural_Posterior
GAACCGCTCCAACTGG-1	Neural_Anterior
GAACCGCTCCGCCTAT-1	Neural_Anterior
GAACCGCTCCTAAGTA-1	Neural_Anterior
GAACCGCTCCTCAGCT-1	Neural_Posterior
GAACCGCTCGATAACC-1	Neural_Posterior
GAACCGCTCGATTTGA-1	Neural_Anterior
GAACCGCTCTTGCAGG-1	Neural_Posterior
GAACCTGTCTACCTCA-1	Neural_Posterior
GAACCTTAGAGGAGGA-1	Neural_Anterior
GAACCTTAGCACAGCC-1	Neural_Anterior
GAACCTTAGTGTTGCG-1	Neural_Posterior
GAACCTTAGTTTGCGG-1	Neural_Posterior
GAACGAATCATGAGCT-1	Neural_Posterior
GAACGAATCCCATAGG-1	Neural_Posterior
GAACGAATCCTAGTTT-1	Neural_Anterior
GAACTTATCAATTGGC-1	Neural_Anterior
GAACTTATCCACCCTG-1	Neural_Posterior
GAACTTATCGCTATAA-1	Neural_Posterior
GAACTTATCTGTGAGT-1	Neural_Posterior
GAACTTATCTTGGATA-1	Neural_Posterior
GAAGCCTGTATTGTGG-1	Neural_Posterior
GAAGCCTGTGATCATG-1	Neural_Anterior
GAAGCCTGTGCAATGC-1	Neural_Posterior
GAAGCCTGTGGTTATG-1	Neural_Posterior
GAAGCCTGTTAAATGC-1	Neural_Posterior
GAAGCCTGTTCACCCA-1	Neural_Posterior
GAAGCTAAGACAACGA-1	Neural_Anterior
GAAGCTAAGCTGTCAG-1	Neural_Anterior
GAAGCTAAGGAACACA-1	Neural_Anterior
GAAGCTAAGTTGCGTG-1	Neural_Posterior
GAAGGAACAGGCCTTG-1	Neural_Anterior
GAAGGAACATAGCGAG-1	Neural_Anterior
GAAGGAACATAGTCAT-1	Neural_Anterior
GAAGGAACATTAAACC-1	Neural_Posterior
GAAGGATGTCAAGACC-1	Neural_Posterior
GAAGGATGTGGAAGGC-1	Neural_Anterior
GAAGGCCCAACAACAA-1	Neural_Anterior
GAAGGCCCAACCGCCA-1	Neural_Posterior
GAAGGCCCACTATGGC-1	Neural_Anterior
GAAGGCTAGCGTGCAC-1	Neural_Posterior
GAAGGCTAGTATTGCA-1	Neural_Anterior
GAAGGCTAGTTAGCCG-1	Neural_Anterior
GAAGTAAGTCACAGCG-1	Neural_Posterior
GAAGTAAGTCATAAGT-1	Neural_Posterior
GAAGTAAGTGTTGCTT-1	Neural_Posterior
GAAGTAAGTTAGGACC-1	Neural_Posterior
GAAGTAAGTTAGGTGC-1	Neural_Posterior
GAAGTATAGCTCCCTG-1	Neural_Anterior
GAAGTATAGTTTGAGC-1	Neural_Posterior
GAAGTCAAGGGCTTAT-1	Neural_Posterior
GAAGTGATCGATATTG-1	unassigned
GACAATACAAAGCTAA-1	Neural_Posterior
GACAATACAACTAACT-1	Neural_Anterior
GACAATACAGCAACCT-1	Neural_Anterior
GACACCGGTGCAACTA-1	Muscle
GACACCGGTTCATCTA-1	Neural_Anterior
GACACCGGTTCGGGAT-1	Neural_Anterior
GACACTAGTCTAACCT-1	Neural_Anterior
GACATAGAGAATCGCT-1	Neural_Posterior
GACATAGAGAGGGACT-1	Neural_Anterior
GACATAGAGATGGACA-1	Neural_Posterior
GACATAGAGCCACATG-1	Neural_Anterior
GACATAGAGGGATGAC-1	Neural_Anterior
GACATAGAGGGATTAG-1	Neural_Anterior
GACATAGAGTATCGCG-1	Muscle
GACATTATCAGGCTAT-1	Neural_Anterior
GACATTATCCTAAGAC-1	Neural_Posterior
GACATTATCGCGCTAA-1	Neural_Posterior
GACATTATCGGCCATA-1	Neural_Posterior
GACCGAACATCGCTTT-1	Neural_Anterior
GACCGTTCACGAATCC-1	Neural_Anterior
GACCTAAGTCTAACAG-1	Neural_Anterior
GACCTAAGTGAAGCCT-1	Neural_Posterior
GACCTAAGTGTTTGTC-1	Neural_Posterior
GACCTAGTCGTTACAA-1	Neural_Anterior
GACCTGATCACGCGGT-1	Neural_Posterior
GACCTGATCGCCTAAG-1	Neural_Anterior
GACCTGATCGGCCATA-1	Neural_Posterior
GACCTGCAGGCAAGTA-1	Neural_Posterior
GACCTGCAGGCAATAG-1	Muscle
GACCTGCAGGCTACAT-1	Neural_Posterior
GACCTTTGTTGCGGAT-1	Neural_Posterior
GACCTTTGTTTAGCTC-1	Neural_Anterior
GACGCAACAACTCGCG-1	Neural_Posterior
GACGCAACATTGCGTA-1	Neural_Anterior
GACGCCTAGCACAGCC-1	Neural_Anterior
GACGCCTAGGGTGGAT-1	Neural_Anterior
GACGTAAAGAACCTGT-1	Muscle
GACGTAAAGCCTGTTC-1	Neural_Anterior
GACGTAAAGGAGGTTA-1	Neural_Posterior
GACGTAAAGTTCCCGT-1	Neural_Posterior
GACTAATGTTCGGGAT-1	Neural_Anterior
GACTATTCAAAGCGCA-1	Neural_Anterior
GACTATTCACACCAAC-1	Neural_Anterior
GACTTACAGCTCAAAC-1	Neural_Anterior
GACTTACAGGAAACTG-1	Neural_Anterior
GACTTACAGGGACGCA-1	Neural_Anterior
GACTTAGGTCGTTACT-1	Neural_Anterior
GACTTAGGTTCCTGTG-1	Neural_Anterior
GACTTAGGTTCGGGAT-1	Somites
GACTTGGTCCGCCAAA-1	Neural_Posterior
GAGAAACGTCCAAGAC-1	Neural_Anterior
GAGAAACGTGGGAACA-1	Neural_Posterior
GAGAAACGTTAGCCAA-1	Neural_Posterior
GAGAACCAGAGGGACT-1	Neural_Posterior
GAGAACCAGCTTAGCG-1	Neural_Anterior
GAGAACCAGGAACGCG-1	Neural_Posterior
GAGAACCAGGTTACAC-1	Neural_Posterior
GAGAACCAGTCATTGA-1	Neural_Posterior
GAGAGGCGTAATCGCA-1	Neural_Anterior
GAGAGGCGTAGCCTAA-1	Neural_Anterior
GAGAGGCGTCACCTAT-1	Neural_Anterior
GAGAGGCGTCACTCGC-1	Neural_Posterior
GAGAGGCGTCGTTACT-1	Neural_Posterior
GAGAGGCGTGCAACTA-1	Neural_Posterior
GAGAGGCGTGCAATAT-1	Somites
GAGAGGCGTGGGAACA-1	Neural_Anterior
GAGAGGCGTTTAACGG-1	Neural_Anterior
GAGATAAGTACGATTG-1	Neural_Anterior
GAGATAAGTCCGCTGT-1	Neural_Posterior
GAGATAAGTTTGGCTT-1	Neural_Anterior
GAGCAAATCAACCAAC-1	Neural_Anterior
GAGCAAATCAGGGCCT-1	Neural_Anterior
GAGCAAATCGCGCTAA-1	Neural_Posterior
GAGCAAATCTTGTTCG-1	Neural_Anterior
GAGCAAGGTGAGGTGA-1	Neural_Anterior
GAGCATGCAACCCTCC-1	Neural_Anterior
GAGCATGCAGGTTACC-1	Neural_Anterior
GAGCCACTCATGCCTC-1	Neural_Posterior
GAGCCACTCCAAGTGT-1	Neural_Posterior
GAGCCTTCAATAGTCT-1	Neural_Anterior
GAGCCTTCACTTACAG-1	Neural_Posterior
GAGCCTTCAGCAACAG-1	Somites
GAGCGAAGTCATAGAT-1	Neural_Posterior
GAGCGAAGTTAGGCTA-1	Neural_Anterior
GAGCGATAGACTAAGG-1	Neural_Anterior
GAGCGATAGGTTTACA-1	Neural_Posterior
GAGCGGTCAAGGATTA-1	Neural_Posterior
GAGCGGTCAATGCCCG-1	Muscle
GAGCGGTCAGGCCTTG-1	Neural_Posterior
GAGCGGTCAGTACCGT-1	Neural_Anterior
GAGCGGTCATGACTAT-1	Neural_Posterior
GAGCTAGCACCCTCAC-1	Neural_Posterior
GAGCTGCTCAGGCTAT-1	Neural_Posterior
GAGCTTAGTAATTAGC-1	Neural_Anterior
GAGCTTAGTCCTTCAG-1	Neural_Anterior
GAGCTTAGTCGTTATC-1	Neural_Anterior
GAGCTTAGTGGATGTC-1	Neural_Posterior
GAGCTTGTCACAGCGC-1	Neural_Anterior
GAGCTTGTCAGGAACA-1	Neural_Anterior
GAGCTTGTCCTTTACG-1	Neural_Anterior
GAGCTTGTCGCCTAAG-1	Neural_Anterior
GAGGAGGCACGTAAGG-1	Neural_Posterior
GAGGAGGCATTATGCG-1	Muscle
GAGGCAAGTCGTAATG-1	Neural_Posterior
GAGGCAAGTGCTAGCG-1	Neural_Anterior
GAGGCAAGTTAGGATT-1	Somites
GAGGCAAGTTTGCGAA-1	Neural_Posterior
GAGGCCTTCCAAGTTA-1	Neural_Posterior
GAGGCCTTCTGCAAAC-1	Neural_Posterior
GAGGCTACACTTACAG-1	Neural_Anterior
GAGGCTTGTCAAACTG-1	Neural_Anterior
GAGGCTTGTCACAAAT-1	Neural_Anterior
GAGGCTTGTTCCGGCT-1	Neural_Posterior
GAGGCTTGTTTCGCCA-1	Neural_Anterior
GAGGGAGCAAAGCTAA-1	Neural_Posterior
GAGGGAGCATGTTGTG-1	Neural_Anterior
GAGGTACAGCTGTACG-1	Neural_Anterior
GAGGTACAGGGCTAAA-1	Somites
GAGGTACAGTGAGCAA-1	Neural_Posterior
GAGGTGAGTATACTGG-1	Neural_Posterior
GAGGTGAGTTGGCCGA-1	Neural_Anterior
GAGGTGAGTTTGTTGC-1	Neural_Anterior
GAGGTTAAGCCACATG-1	Muscle
GAGTAACCAATTGAAG-1	Neural_Anterior
GAGTAACCACAATTAC-1	Neural_Anterior
GAGTAACCATAAAGCA-1	Neural_Anterior
GAGTAATAGGTTACAC-1	Somites
GAGTATCTCAATCATG-1	Neural_Anterior
GAGTATCTCGATTCTT-1	Neural_Anterior
GAGTCATTCAAGCTTA-1	Neural_Anterior
GAGTCATTCATCACTT-1	Neural_Anterior
GAGTCATTCGCTATGG-1	Neural_Posterior
GAGTGAGGTCACCTAT-1	Neural_Anterior
GAGTGAGGTGGACCTG-1	Neural_Posterior
GAGTGAGGTTAGACCA-1	Somites
GAGTGATCACCTGCCT-1	Neural_Anterior
GAGTGATCATGTCAAT-1	Neural_Anterior
GAGTGTTTCAATGAGG-1	Neural_Anterior
GAGTGTTTCCCTCTAA-1	Neural_Posterior
GAGTGTTTCCTTGCGT-1	Neural_Anterior
GAGTTACTCACCGGTA-1	Neural_Anterior
GAGTTGCGTACCCACC-1	Neural_Posterior
GAGTTGCGTAGGTTGC-1	Neural_Anterior
GAGTTTGGTAACAGGG-1	Neural_Anterior
GAGTTTGGTAATCGTG-1	Neural_Posterior
GATAAAGGTCAGGCAT-1	Neural_Anterior
GATAATCGTACCCACC-1	Neural_Anterior
GATAATCGTTAGCAGC-1	Neural_Posterior
GATAGACCAATATGGA-1	Neural_Anterior
GATAGACCACCGTTCC-1	Neural_Anterior
GATAGACCACTGGCTG-1	Neural_Posterior
GATAGACCAGGCTAGA-1	Neural_Posterior
GATCAAGAGTAGAGGC-1	Neural_Posterior
GATCAAGAGTCGCAAT-1	Neural_Posterior
GATCACTAGACAACGA-1	Neural_Posterior
GATCACTAGCTGGACC-1	Neural_Anterior
GATCACTAGCTTTGGG-1	Neural_Posterior
GATCACTAGGTGCGGA-1	NMPs
GATCACTAGTAACGAG-1	Neural_Anterior
GATCACTAGTAGGCGG-1	Neural_Posterior
GATCAGGCAGACAAAC-1	unassigned
GATCAGGCAGCCTTGG-1	Neural_Posterior
GATCAGGCAGGCTTCG-1	Neural_Posterior
GATCAGGCATCCCTCA-1	Neural_Posterior
GATCAGTTCCCATAGG-1	Neural_Anterior
GATCAGTTCGAAGCGG-1	Neural_Posterior
GATCAGTTCGGTTTGG-1	Neural_Anterior
GATCAGTTCTACCTAT-1	Neural_Anterior
GATCCGTCAACACCTA-1	Neural_Posterior
GATCCGTCAAGGACCA-1	Neural_Anterior
GATCCGTCAGCATGTC-1	Neural_Posterior
GATCGAGCAGCATTAT-1	Neural_Anterior
GATCGATTCAAGCCTG-1	Neural_Anterior
GATCGATTCACGCATG-1	Neural_Anterior
GATCGATTCCCGCCTA-1	Neural_Anterior
GATCGATTCGAAGTGA-1	Neural_Anterior
GATCGATTCGCAATCG-1	Neural_Posterior
GATCGCTCAATATACC-1	Neural_Anterior
GATCGCTCACTAGGTC-1	Neural_Anterior
GATCGCTCAGTTAAAG-1	Neural_Anterior
GATCGCTCATGTTTGG-1	Neural_Posterior
GATCGCTCATTGCAGC-1	Neural_Posterior
GATGACTTCAAACCGT-1	Neural_Anterior
GATGAGGGTCCGCTGT-1	Neural_Anterior
GATGAGGGTCCTGATT-1	Neural_Anterior
GATGAGGGTGAATCGC-1	Neural_Anterior
GATGAGGGTGCTCCGT-1	Neural_Posterior
GATGAGGGTGTTTGCT-1	Neural_Anterior
GATGAGGGTTGCATCT-1	Neural_Anterior
GATGAGGGTTTATCTG-1	Muscle
GATGCAGCAAGCGATG-1	Neural_Posterior
GATGCAGCACAGGAAT-1	Neural_Posterior
GATGCAGCACCGGCTA-1	Neural_Anterior
GATGCAGCATGGCCCA-1	PSM
GATGCAGCATTGTGCA-1	Neural_Posterior
GATGCATTCGTCCTTA-1	Neural_Posterior
GATGCGACACTTGTTC-1	Neural_Posterior
GATGCTTAGCCAGGTC-1	Neural_Anterior
GATGCTTAGTCACCTC-1	Neural_Anterior
GATGCTTAGTTATTCC-1	Somites
GATGGACAGAATCGCT-1	Neural_Posterior
GATGGACAGCACAGGG-1	Neural_Anterior
GATGGACAGCATGGTT-1	Neural_Anterior
GATGGACAGCCGCAAC-1	Muscle
GATGGCTGTCATGAGC-1	Neural_Anterior
GATGGCTGTCTAACAG-1	Neural_Posterior
GATTAAGCAATGAGGT-1	Somites
GATTAAGCATTAAACC-1	Neural_Posterior
GATTACGGTAAGCTTG-1	Neural_Posterior
GATTACGGTCATAAGT-1	Neural_Posterior
GATTACGGTTATCGAG-1	Neural_Anterior
GATTACGGTTGAAGCC-1	Neural_Anterior
GATTACTCAAGCTTTG-1	Neural_Posterior
GATTACTCAATTGACT-1	Neural_Anterior
GATTACTCAATTGAGA-1	Neural_Posterior
GATTACTCACATACTG-1	Neural_Posterior
GATTACTCAGGCGAGT-1	Neural_Anterior
GATTAGCTCATCAGTA-1	Neural_Posterior
GATTAGCTCTCGCCTG-1	Neural_Posterior
GATTAGTGTAGTTAAC-1	Neural_Anterior
GATTAGTGTTGTTGGA-1	Neural_Anterior
GATTATGTCAGGGCCT-1	Neural_Anterior
GATTATGTCGCTAGTG-1	Neural_Anterior
GATTATGTCTGTGCCT-1	Neural_Anterior
GATTCAATCATTGTCT-1	Neural_Anterior
GATTCAATCTGTGCCT-1	Neural_Posterior
GATTCAATCTTGGACG-1	Neural_Posterior
GATTCAGGTCAAAGGG-1	Neural_Posterior
GATTCAGGTTATAGCG-1	Neural_Posterior
GATTCAGGTTATCGAG-1	Neural_Anterior
GATTCATCAATTGAGA-1	Neural_Posterior
GATTCATCATACCCGG-1	Neural_Posterior
GATTCATCATTGTCAG-1	Neural_Anterior
GATTCCTGTAGCTAAT-1	Neural_Anterior
GATTCCTGTAGGTTTG-1	Neural_Anterior
GATTCCTGTATTGCAG-1	Neural_Posterior
GATTCCTGTCGCATAA-1	Neural_Posterior
GATTCCTGTTAGAGCC-1	Neural_Anterior
GATTCGCCAATCTCTC-1	Neural_Posterior
GATTCGCCACCTGGTG-1	Neural_Posterior
GATTGCAGTCCAAGAC-1	Muscle
GATTGCAGTTGAGCCG-1	Neural_Anterior
GATTGCGTCGGTTTCC-1	Neural_Anterior
GATTGGCGTACCGTAA-1	Somites
GATTGGCGTGTTTCAC-1	Neural_Anterior
GATTGGTTCCAATAGC-1	Neural_Posterior
GATTGGTTCGATAACC-1	Neural_Anterior
GATTGGTTCGGTCATG-1	Neural_Anterior
GATTGTTCAGCAAATA-1	Neural_Posterior
GATTGTTCATGAATCT-1	Neural_Anterior
GATTTGCAGGATCCGC-1	Neural_Anterior
GATTTGCAGTATTGTG-1	Neural_Anterior
GATTTGCAGTTAGTTG-1	Neural_Anterior
GCAAACAAGCTTATGA-1	Neural_Anterior
GCAAACAAGCTTTGTT-1	Neural_Posterior
GCAAACAAGGACCTGC-1	Neural_Anterior
GCAAACCGTTTGAGGC-1	Neural_Anterior
GCAAACTTCCTGGCTT-1	Neural_Posterior
GCAACAGCATAGACTT-1	Neural_Anterior
GCAAGCCTCAAAGGCA-1	Neural_Posterior
GCAAGCCTCGCTAAGT-1	Neural_Anterior
GCAAGCCTCTCAATAG-1	Neural_Anterior
GCAAGTCGTTTAAAGC-1	Neural_Anterior
GCAAGTGCAATATAGG-1	Neural_Posterior
GCAAGTGCAATGCCCG-1	Muscle
GCAAGTGCACCAGCAT-1	Neural_Anterior
GCAAGTGCATAATCGT-1	Neural_Anterior
GCAAGTGCATCAATCG-1	Neural_Anterior
GCAATAGAGAACAAGT-1	Neural_Anterior
GCAATAGAGATGGACA-1	Neural_Posterior
GCAATAGAGCAAACCT-1	Neural_Anterior
GCAATATGTCAATACG-1	Neural_Posterior
GCAATATGTTGTGACA-1	Neural_Posterior
GCAATATGTTGTTGTC-1	Neural_Anterior
GCAATCTAGCAACAAG-1	Neural_Anterior
GCAATCTAGCGGATAA-1	Neural_Posterior
GCAATCTAGCGGCTGT-1	Neural_Anterior
GCAATCTAGGACAATG-1	Neural_Posterior
GCAATCTAGGATTGAG-1	Neural_Posterior
GCAATCTAGGGCTTTG-1	Neural_Anterior
GCAATGAAGCAACAAG-1	Neural_Anterior
GCAATGAAGCAAGACA-1	Neural_Anterior
GCAATGAAGGAGGCAT-1	Neural_Anterior
GCAATGAAGGCTCATG-1	Neural_Posterior
GCAATGTTCCAGCACA-1	Neural_Anterior
GCACATTAGATAAAGC-1	Muscle
GCACATTAGGAACCAA-1	Neural_Anterior
GCACATTAGGCAGGTG-1	Neural_Anterior
GCACATTAGTCCTGAG-1	Neural_Posterior
GCACATTAGTTAGGCT-1	Neural_Anterior
GCACCTAAGGCGCTAC-1	Neural_Anterior
GCACCTAAGTAGCGGG-1	Neural_Anterior
GCACGAACATACCCGG-1	Neural_Posterior
GCACGAACATAGCTGC-1	Neural_Anterior
GCACGCTAGGACCTGC-1	Neural_Posterior
GCACGCTAGGGTTATC-1	Neural_Anterior
GCACGCTAGGTTTACA-1	Neural_Anterior
GCACGCTAGTCGCTAG-1	Neural_Posterior
GCACGGTTCACGTTAA-1	Neural_Anterior
GCACGGTTCACTAAGC-1	Neural_Posterior
GCACGGTTCGAGCTAT-1	Neural_Anterior
GCACGGTTCGATTATG-1	Neural_Anterior
GCACGGTTCTAGCTTT-1	Somites
GCACTAAGTCCCGAAG-1	Neural_Anterior
GCACTAAGTGTGAGGA-1	Neural_Anterior
GCACTTACAATGAATG-1	Neural_Anterior
GCACTTACATGTGGGA-1	Neural_Posterior
GCAGCAACAAAGCTCC-1	Neural_Anterior
GCAGCAACACGTTACA-1	Neural_Posterior
GCAGCAACAGCTTAAT-1	Neural_Anterior
GCAGCAACATCGCTTT-1	Neural_Anterior
GCAGCAACATTATGCG-1	Neural_Anterior
GCAGCCAGTCCTAAGA-1	Neural_Anterior
GCAGCCAGTTGCCTCA-1	Neural_Anterior
GCAGCTATCACACAGT-1	Neural_Anterior
GCAGCTATCCAGGAAA-1	Neural_Anterior
GCAGCTATCTAAGTGC-1	Neural_Anterior
GCAGGAAGTGATGATT-1	Neural_Posterior
GCAGGAAGTGCTCACC-1	Neural_Anterior
GCAGGAAGTTTCGCCA-1	Neural_Posterior
GCAGGACCACCTAATG-1	Neural_Anterior
GCAGGATAGTAAGTCC-1	Neural_Posterior
GCAGGATAGTAGCCAT-1	Neural_Anterior
GCAGGCAAGCGGATAA-1	Neural_Anterior
GCAGGCAAGGCGAAAC-1	Neural_Posterior
GCAGGCAAGTTTCCTG-1	Neural_Anterior
GCAGGCTTCGATCAGT-1	Neural_Anterior
GCAGGCTTCGTGCCTT-1	Neural_Posterior
GCAGGCTTCTTTAGGA-1	Neural_Posterior
GCAGGTGAGTCATTTC-1	Neural_Anterior
GCAGGTTGTGTGTGGT-1	Neural_Posterior
GCAGGTTGTTTAGCTC-1	Neural_Anterior
GCATATATCAGGAAGC-1	Neural_Anterior
GCATATATCCCTGTTA-1	Neural_Anterior
GCATATATCTTAATGG-1	Neural_Anterior
GCATCCTTCCTAAGAC-1	Somites
GCATCCTTCGAAGTAG-1	Neural_Anterior
GCATCCTTCTGTAAGC-1	Neural_Anterior
GCATGAAAGCAGCTCA-1	Neural_Anterior
GCATGAAAGCCTAATA-1	Muscle
GCATGAAAGGCGAATA-1	Neural_Anterior
GCATGAGCAATCGCAC-1	Neural_Posterior
GCATGAGCACAAAGCG-1	Neural_Posterior
GCATGAGCATGATTGT-1	Neural_Anterior
GCATTAGGTCATAAGT-1	Neural_Anterior
GCATTAGGTGCTAGCG-1	Neural_Anterior
GCATTAGGTTAGAGCC-1	Neural_Anterior
GCATTAGGTTATCCTA-1	Neural_Posterior
GCATTGCCATGAGTTT-1	Neural_Posterior
GCCAATAGTTGGATAT-1	Neural_Anterior
GCCAATTAGGCTACTG-1	Muscle
GCCAATTAGTAACCCG-1	Neural_Posterior
GCCAATTAGTAACGGA-1	Neural_Anterior
GCCAATTAGTCACGAT-1	Neural_Anterior
GCCACAATCAAACCGT-1	Neural_Posterior
GCCACAATCGTTATCT-1	Neural_Posterior
GCCACAATCTAATTGG-1	Neural_Posterior
GCCACACAGCATGGTT-1	Neural_Anterior
GCCACACAGGCTAAGA-1	Neural_Posterior
GCCACACAGTCATTAG-1	Neural_Anterior
GCCACACAGTCCTTTG-1	Neural_Anterior
GCCACACAGTGGCGGA-1	NMPs
GCCACTAAGTAACCAC-1	Neural_Posterior
GCCAGGAAGCATTAGC-1	Neural_Posterior
GCCAGGAAGCCACATG-1	Neural_Posterior
GCCATGATCATGCGTG-1	Neural_Anterior
GCCATGATCCGGCTAA-1	Neural_Anterior
GCCATGATCGCGACAC-1	Neural_Anterior
GCCATGATCTAATCCT-1	Neural_Posterior
GCCATGATCTTGCTAT-1	Neural_Posterior
GCCATTACAAGCGATG-1	Neural_Posterior
GCCATTACAATAATCC-1	Neural_Posterior
GCCCAAATCGTTACAA-1	Neural_Anterior
GCCCATAAGGCACAGG-1	Neural_Posterior
GCCCGTTGTGTAACCA-1	Neural_Anterior
GCCCGTTGTTAGCATG-1	Neural_Anterior
GCCCTCATCAATGACC-1	Somites
GCCCTCATCCTGAGTG-1	Neural_Anterior
GCCCTCATCGGTTTCC-1	Neural_Anterior
GCCCTCATCGTAACGT-1	Neural_Posterior
GCCGTGAGTTCACTGT-1	Somites
GCCTAATAGATAGACG-1	Somites
GCCTAATAGCTCATAA-1	Neural_Anterior
GCCTAATAGGCGCATC-1	Neural_Anterior
GCCTAATAGGCGTAAA-1	Neural_Anterior
GCCTAATAGTCACTCC-1	Neural_Posterior
GCCTACTTCCGGAACC-1	Muscle
GCCTACTTCCTAACGG-1	Neural_Posterior
GCCTACTTCGCATCCT-1	Neural_Posterior
GCCTATTGTCAAGTAT-1	Neural_Anterior
GCCTATTGTCCTAGTT-1	Neural_Anterior
GCCTATTGTCTCAGCC-1	Neural_Anterior
GCCTCAAAGGCCTAAT-1	Neural_Anterior
GCCTCAAAGGCCTGGT-1	Neural_Anterior
GCCTCAAAGTCATTGA-1	Neural_Posterior
GCCTCAAAGTTATGTG-1	Neural_Anterior
GCCTCCATCATTGTTC-1	Neural_Posterior
GCCTCCATCTTACTCG-1	Neural_Anterior
GCCTCGACAAGCTACC-1	Neural_Posterior
GCCTCGACAGCCTAAC-1	Neural_Posterior
GCCTGACAGAGGCTAA-1	Neural_Anterior
GCCTGAGGTAACCTAG-1	Muscle
GCCTGAGGTCTAACAG-1	Neural_Anterior
GCCTGCTGTGCATTTC-1	Neural_Anterior
GCCTGCTGTTATCCGT-1	Neural_Anterior
GCCTGCTGTTGCACGG-1	Neural_Anterior
GCCTGTGCAAGCTTTG-1	Neural_Anterior
GCCTGTGCACCTACGG-1	Neural_Posterior
GCCTTAACAAAGCGCA-1	Neural_Posterior
GCCTTAACAGTCTATG-1	Neural_Anterior
GCCTTAACATAGACTT-1	Neural_Posterior
GCCTTACTCCGGGACT-1	Neural_Posterior
GCCTTACTCCTCACTA-1	Neural_Posterior
GCCTTACTCGCTATAA-1	Neural_Anterior
GCCTTAGAGAACCTGT-1	Neural_Anterior
GCCTTAGAGGATTGCT-1	Neural_Anterior
GCCTTAGAGGTACCGC-1	Neural_Posterior
GCCTTGCGTAAGTCGC-1	Neural_Anterior
GCCTTGCGTACCGGAT-1	Neural_Anterior
GCCTTGCGTGACCTGG-1	Neural_Anterior
GCCTTGCGTTAGGATT-1	Neural_Anterior
GCCTTTATCACACAGT-1	Neural_Anterior
GCCTTTATCCTAATTC-1	Somites
GCCTTTATCCTCCATA-1	Neural_Posterior
GCCTTTATCTCACTCA-1	Neural_Anterior
GCCTTTGGTCCTAACT-1	Neural_Anterior
GCCTTTGGTTCACCAT-1	Neural_Posterior
GCCTTTGGTTCGCGCT-1	Neural_Anterior
GCGAAGCCAGCCAGTT-1	Neural_Anterior
GCGAAGCCATGGAGGC-1	Neural_Anterior
GCGAGTGAGTCAATTG-1	Neural_Posterior
GCGAGTGAGTGACCTG-1	Neural_Posterior
GCGATATTCACAGCCA-1	Neural_Anterior
GCGATATTCACGCCAA-1	Neural_Anterior
GCGATATTCGACCTGA-1	Neural_Anterior
GCGATTAGTAACAGGG-1	Neural_Posterior
GCGATTAGTCTCACTG-1	Neural_Anterior
GCGATTAGTGGTTCTT-1	Neural_Posterior
GCGATTAGTTAGTTGG-1	unassigned
GCGATTAGTTATGTGG-1	Neural_Posterior
GCGATTTAGACTATTG-1	Neural_Anterior
GCGATTTAGGACTAAG-1	Neural_Posterior
GCGATTTAGGAGCAAC-1	Muscle
GCGATTTAGGGATTAG-1	Neural_Posterior
GCGATTTAGTGAAGTG-1	Neural_Anterior
GCGCAAACAAGCTTAT-1	Neural_Posterior
GCGCAAACAGCGCTTG-1	Neural_Posterior
GCGCAAACATAGTCAT-1	Neural_Anterior
GCGCAATGTCACCTAT-1	Neural_Anterior
GCGCAATGTCATAGAT-1	Neural_Posterior
GCGCAATGTCCAAGAC-1	Neural_Posterior
GCGCAATGTGTGCACG-1	Somites
GCGCAATGTTAATGAC-1	Neural_Posterior
GCGCCTTGTGTTAAAC-1	Neural_Posterior
GCGCCTTGTTAACGGC-1	Neural_Posterior
GCGCCTTGTTACGCAA-1	Neural_Anterior
GCGCCTTGTTGTCCAT-1	Neural_Posterior
GCGCGATTCGATAACC-1	Neural_Anterior
GCGCGATTCGTGCTAG-1	Neural_Posterior
GCGCTAGGTAGTTAAC-1	Neural_Anterior
GCGCTAGGTCCTTAGT-1	Neural_Anterior
GCGCTAGGTTCCTCCT-1	Neural_Posterior
GCGCTTAAGGCATTAC-1	Neural_Posterior
GCGCTTAAGGCCAATT-1	Neural_Anterior
GCGCTTAAGGTATTGC-1	Neural_Anterior
GCGCTTGCAGCAATAA-1	Neural_Posterior
GCGGAACCAAACTGTT-1	Neural_Posterior
GCGGAACCAAGTGTTT-1	Neural_Anterior
GCGGATACAAACAACA-1	Neural_Anterior
GCGGATACAAACTCAT-1	Neural_Posterior
GCGGATACACACAATT-1	Neural_Posterior
GCGGATACACACTAAT-1	Neural_Anterior
GCGGATACACCAGGTT-1	Neural_Posterior
GCGGATACACCCTCAC-1	Neural_Anterior
GCGGATACACTATGGC-1	Neural_Anterior
GCGGGTTTCCGCAAGC-1	Neural_Posterior
GCGGGTTTCTCACAAA-1	Neural_Anterior
GCGGTTATCACGCATG-1	Neural_Posterior
GCGGTTATCCTCCATA-1	Neural_Posterior
GCGGTTGGTAACGAGG-1	Neural_Posterior
GCGGTTGGTCCTTAGT-1	Neural_Anterior
GCGGTTGGTTCATTTG-1	Neural_Anterior
GCGTAACGTAAGCTCA-1	Neural_Anterior
GCGTAACGTATGGTGC-1	Neural_Posterior
GCGTAACGTTAGGATT-1	Neural_Posterior
GCGTGCTAGAACCTAC-1	Neural_Posterior
GCGTGCTAGTTGGATC-1	Neural_Posterior
GCGTTTCTCTAATTGG-1	Neural_Posterior
GCTAACAGTAATCGTG-1	Neural_Anterior
GCTAACAGTGGCTTCC-1	Neural_Posterior
GCTAACCCAAATTCGT-1	Neural_Posterior
GCTAACCCAATTAGCT-1	Neural_Anterior
GCTAACCCAGTTATGT-1	Neural_Anterior
GCTAACCCATACCCGG-1	Neural_Anterior
GCTAACCCATTAAGTC-1	Neural_Posterior
GCTAAGAAGACAAAGT-1	Neural_Anterior
GCTAAGAAGATAAAGC-1	Neural_Posterior
GCTAAGAAGCAAGACA-1	Neural_Posterior
GCTAAGAAGGTTACGT-1	Neural_Posterior
GCTAAGAAGTAAAGGT-1	Neural_Anterior
GCTAAGCGTAATTAGC-1	Neural_Anterior
GCTAAGCGTCACGGAT-1	Neural_Anterior
GCTAAGTTCAAAGGCA-1	Neural_Anterior
GCTAAGTTCATCAGTA-1	Neural_Anterior
GCTAAGTTCCAAACAC-1	Neural_Anterior
GCTAAGTTCGGGACTC-1	Neural_Posterior
GCTAAGTTCTGTTCAT-1	Neural_Posterior
GCTAATATCACAGGAA-1	Neural_Posterior
GCTAATATCCATAAGC-1	Neural_Posterior
GCTAATATCGGTTCCT-1	Neural_Posterior
GCTAATATCGTTAACA-1	Neural_Anterior
GCTAATATCTCCTCAA-1	Neural_Anterior
GCTAGCCAGCTATGAC-1	Muscle
GCTAGCCAGGTCCTGA-1	Neural_Posterior
GCTAGCCAGGTTAGCT-1	Neural_Anterior
GCTAGCGGTCACCTAT-1	Neural_Anterior
GCTAGCGGTCCTAGTT-1	Neural_Anterior
GCTAGCTCAAACATAG-1	Neural_Anterior
GCTAGCTCACAAAGCG-1	Neural_Posterior
GCTAGCTCATGAATCT-1	Neural_Anterior
GCTAGTGTCATTACAG-1	Neural_Anterior
GCTAGTGTCCTCACAC-1	Neural_Anterior
GCTAGTGTCGCATCCT-1	Neural_Posterior
GCTATAGGTAATAACC-1	Neural_Anterior
GCTATAGGTATTCGTC-1	Neural_Posterior
GCTATAGGTTCAAGCA-1	Neural_Anterior
GCTATCCTCACAGCGC-1	Neural_Posterior
GCTATCCTCACCGGTA-1	Somites
GCTATCCTCCTAACGG-1	Neural_Anterior
GCTATCCTCGCTAAAC-1	Neural_Posterior
GCTATCCTCTTGAGGT-1	Neural_Anterior
GCTATTGCAAGCGATG-1	Neural_Posterior
GCTATTGCAAGGTCCT-1	Neural_Anterior
GCTATTGCATGCAACC-1	Neural_Anterior
GCTATTGCATTAGGCC-1	Neural_Posterior
GCTCAACCAAATATCC-1	Neural_Posterior
GCTCAACCAAGGACCA-1	Neural_Anterior
GCTCAACCAGCTCAAC-1	Neural_Anterior
GCTCACAAGGAACCAA-1	Somites
GCTCACAAGTTAGCTA-1	Neural_Posterior
GCTCACAAGTTATTCC-1	Neural_Posterior
GCTCATTGTAACCTAG-1	Neural_Anterior
GCTCATTGTAATCGGC-1	Neural_Posterior
GCTCATTGTTACTAGG-1	Muscle
GCTCATTGTTTGAGCA-1	Neural_Posterior
GCTCCTTAGGTAAGCA-1	Neural_Anterior
GCTCCTTAGTGTGATC-1	Neural_Anterior
GCTCGATCAATTAACC-1	Neural_Posterior
GCTCGATCAGCAACAG-1	Neural_Posterior
GCTCTGGCAAGCGAGC-1	Neural_Anterior
GCTCTGGCAATACTGT-1	Somites
GCTCTGGCAGCCTTGG-1	Neural_Anterior
GCTCTGGCATTGACAT-1	Neural_Posterior
GCTCTGTTCCAGGTCA-1	Neural_Posterior
GCTGACATCACGCGGT-1	Neural_Posterior
GCTGACCAGACAACAG-1	Neural_Posterior
GCTGACCAGCACTAGT-1	Neural_Posterior
GCTGACCAGCCACATG-1	Neural_Anterior
GCTGACCAGCCTGGTA-1	Neural_Anterior
GCTGACCAGGACCTTG-1	Neural_Anterior
GCTGACCAGGTCGAGG-1	Neural_Posterior
GCTGACCAGGTTTACA-1	Neural_Posterior
GCTGAGGAGCAACAAG-1	Neural_Posterior
GCTGAGGAGCATGACT-1	Neural_Anterior
GCTGAGGAGTAAACCC-1	Neural_Posterior
GCTGATCCAAACATAG-1	Neural_Anterior
GCTGATCCAGCACCAT-1	Neural_Anterior
GCTGATCCAGTTTGGC-1	Neural_Anterior
GCTGCAATCACTAAGC-1	Neural_Anterior
GCTGCAATCCCGAACA-1	Neural_Anterior
GCTGCAATCGAGGTGG-1	Neural_Posterior
GCTGCAATCTTGGACG-1	Neural_Anterior
GCTGCACAGGCGCTAC-1	Neural_Anterior
GCTGCATCATACTCCT-1	Neural_Anterior
GCTGGATGTCATAACG-1	Neural_Posterior
GCTGGATGTGAGCGAA-1	Neural_Anterior
GCTGGATGTGTTTGCT-1	Neural_Posterior
GCTGGATGTTAGTACG-1	Neural_Posterior
GCTGGTTCAGGTCCTG-1	Neural_Posterior
GCTGTAAGTTAGCTGA-1	Neural_Anterior
GCTGTGATCCGTGACA-1	Neural_Anterior
GCTGTGATCCTTTACG-1	Neural_Anterior
GCTGTGCAGATACTTG-1	Neural_Anterior
GCTGTGCAGTATCGCG-1	Neural_Anterior
GCTGTGCAGTATTGTG-1	Neural_Anterior
GCTTAACAGCGAAGTA-1	Neural_Anterior
GCTTAACAGGCCCAGT-1	Neural_Anterior
GCTTAACAGTAACCCG-1	Neural_Posterior
GCTTAACAGTGTGATC-1	Neural_Anterior
GCTTAACAGTTATCCT-1	Neural_Anterior
GCTTACCTCACTCGCT-1	Neural_Anterior
GCTTACCTCCAGGGAG-1	Neural_Anterior
GCTTACCTCCCGTTAC-1	Neural_Anterior
GCTTACCTCCTAATTC-1	Neural_Anterior
GCTTACCTCGTTACAA-1	Somites
GCTTAGTAGCTATTGA-1	Neural_Anterior
GCTTAGTAGTAAGTGG-1	Somites
GCTTATCGTGTTAGCA-1	Neural_Posterior
GCTTATCGTTCAAGCA-1	Neural_Anterior
GCTTATCGTTTACCGT-1	Neural_Posterior
GCTTATCGTTTGGCTT-1	Neural_Anterior
GCTTCGCGTAGGATTT-1	Neural_Anterior
GCTTCGCGTAGGTGTC-1	Neural_Anterior
GCTTCGCGTCCGTAGG-1	Neural_Anterior
GCTTCGCGTTTGTGGA-1	Neural_Posterior
GCTTGACCAATAAGCA-1	Neural_Posterior
GCTTGTTGTCCCGGAA-1	Neural_Anterior
GCTTGTTGTCGTTACT-1	Neural_Anterior
GCTTGTTGTTCACCCA-1	Neural_Posterior
GCTTGTTGTTGACTTC-1	Neural_Anterior
GCTTGTTGTTGGTTCT-1	Neural_Anterior
GCTTGTTGTTTCAGGA-1	Neural_Posterior
GCTTTACGTAAAGCAA-1	Neural_Anterior
GCTTTACGTAATAGCT-1	Neural_Posterior
GCTTTACGTACCGTTT-1	Neural_Posterior
GCTTTACGTGCACGCA-1	Neural_Posterior
GCTTTACGTTAATGCG-1	Neural_Posterior
GCTTTACGTTTGGGCG-1	Neural_Posterior
GCTTTATTCAATACGC-1	Neural_Anterior
GCTTTATTCACGAATC-1	Neural_Posterior
GCTTTATTCCTGAATA-1	Neural_Posterior
GCTTTATTCGATATTG-1	Neural_Posterior
GCTTTATTCTCAATGA-1	Neural_Anterior
GCTTTCATCAAGCCTG-1	Neural_Posterior
GCTTTCATCCAAACAC-1	Neural_Posterior
GCTTTCATCCGGTTGA-1	Neural_Anterior
GCTTTCATCCTTGCGT-1	Neural_Anterior
GGAAACTCAGTTTGTG-1	Neural_Anterior
GGAACAATCACTTCAT-1	Somites
GGAACAATCTTGCATT-1	Neural_Anterior
GGAACCACAACAGGTG-1	Neural_Anterior
GGAACCACAATTGCGC-1	Neural_Anterior
GGAACCACACTAAGAA-1	Neural_Posterior
GGAACCACAGCTACGT-1	Neural_Posterior
GGAACTAAGCTTGCTC-1	Neural_Anterior
GGAACTAAGGTCAAAG-1	Neural_Posterior
GGAAGCTAGACACCGC-1	Neural_Posterior
GGAAGCTAGATGCCTG-1	Neural_Posterior
GGAAGCTAGCAGGCCT-1	Neural_Anterior
GGAAGCTAGTCATTGA-1	Neural_Posterior
GGAATCTTCCCTGTTA-1	Neural_Anterior
GGAATCTTCTTAGGAC-1	Somites
GGACAGCCAAATTGCT-1	Neural_Anterior
GGACAGCCAGCAAGTG-1	Neural_Anterior
GGACAGCCATGCTCCC-1	Neural_Posterior
GGACAGCCATGGCCTG-1	Neural_Posterior
GGACAGCCATGTTGCA-1	Neural_Anterior
GGACATAAGCAAGATG-1	Neural_Posterior
GGACATAAGCTGGAAA-1	Neural_Anterior
GGACATAAGGTCTTGG-1	Neural_Posterior
GGACATAAGTAAAGGT-1	Neural_Posterior
GGACATAAGTATGTGC-1	Neural_Anterior
GGACATAAGTATTGGC-1	Muscle
GGACCGAAGGCGGATG-1	Neural_Anterior
GGACCGAAGTTACCGG-1	Neural_Anterior
GGACCTCAGATGGAGC-1	Muscle
GGACCTCAGTAGCGGG-1	Neural_Posterior
GGACCTCAGTCTCACC-1	Neural_Anterior
GGACGAAGTCGTTACT-1	Neural_Anterior
GGACGGATCTGGCTTC-1	Neural_Posterior
GGACTAAAGTCAATTG-1	Neural_Posterior
GGACTAAAGTTCCCAC-1	Neural_Anterior
GGAGCAAGTCACAGAC-1	Neural_Posterior
GGAGCAAGTGGCTTCC-1	Muscle
GGAGCAAGTGTGAGGA-1	Neural_Posterior
GGAGCAAGTTGCTGGG-1	Neural_Posterior
GGAGCATAGCATGTTA-1	Muscle
GGAGCATAGCCTGAGC-1	Neural_Posterior
GGAGCATAGGACCTGC-1	Neural_Posterior
GGAGCGATCAAACTCA-1	Neural_Anterior
GGAGCGATCATAACTG-1	Neural_Posterior
GGAGCGATCTCTAGCC-1	Neural_Posterior
GGAGGTTAGACCATAC-1	Neural_Posterior
GGAGGTTAGCAAGACA-1	Neural_Posterior
GGAGGTTAGGATCACT-1	Neural_Anterior
GGAGGTTAGGCCCAGT-1	Neural_Anterior
GGAGGTTAGGTGTCCA-1	Neural_Posterior
GGAGTCTGTAATCGCA-1	Neural_Anterior
GGAGTCTGTAGCAGCT-1	Neural_Posterior
GGAGTCTGTTAGTACG-1	Neural_Anterior
GGAGTCTGTTGCGGAT-1	Neural_Anterior
GGAGTCTGTTTGGTTC-1	Neural_Posterior
GGAGTGAGTCCAAGAC-1	Neural_Anterior
GGAGTGAGTGGTTCCC-1	Neural_Anterior
GGAGTGAGTGTTGTAG-1	Neural_Anterior
GGATACTTCATAACTG-1	Neural_Posterior
GGATACTTCCCTCAAC-1	Neural_Anterior
GGATACTTCCTCCATA-1	Neural_Anterior
GGATACTTCGCCTGTT-1	Neural_Posterior
GGATACTTCTAGCTTT-1	Neural_Anterior
GGATATTGTAGTTACG-1	Neural_Anterior
GGATATTGTGTTGTGA-1	Neural_Anterior
GGATATTGTTCCATTA-1	Neural_Posterior
GGATATTGTTGTAACG-1	Neural_Anterior
GGATGAATCAGCTAAC-1	Neural_Posterior
GGATGAATCTCGACCT-1	Neural_Posterior
GGATGGCCAGGCATCT-1	Neural_Anterior
GGATGGCCAGTAGGTG-1	Neural_Anterior
GGATGTAAGAGGAGTC-1	Neural_Anterior
GGATTATGTCGCATAA-1	Neural_Anterior
GGATTATGTGGATTCA-1	Muscle
GGATTATGTTACAAAC-1	Neural_Anterior
GGATTCAGTAATAACC-1	Neural_Anterior
GGATTCAGTTAGGTTG-1	Neural_Posterior
GGATTGCGTCATGAGC-1	Neural_Posterior
GGATTTATCTATGACA-1	Neural_Anterior
GGCAAATCAAGGTAAC-1	Muscle
GGCAAATCAATCTCTC-1	Neural_Posterior
GGCAAATCAATTGACT-1	Neural_Posterior
GGCAAATCAGGAACCA-1	Neural_Posterior
GGCAAGCCACTAGGTC-1	NMPs
GGCAAGCCAGTTATGT-1	Neural_Posterior
GGCAATCGTAGACAAA-1	Neural_Anterior
GGCAATCGTGCTCACC-1	NMPs
GGCAGGATCATAACTG-1	Neural_Anterior
GGCAGGATCCTCATGC-1	Neural_Posterior
GGCAGGATCGTGCTAG-1	Neural_Posterior
GGCATGGAGGAGGTTA-1	Neural_Anterior
GGCATGGAGTCACTCC-1	Neural_Posterior
GGCATGGAGTTGTCTT-1	Neural_Anterior
GGCATTAGTAGCAGCT-1	Neural_Anterior
GGCATTAGTCAATGTG-1	Neural_Posterior
GGCATTAGTTGGTTAG-1	Neural_Anterior
GGCATTGTCCGCCAAA-1	Neural_Posterior
GGCATTGTCGTTAACA-1	Neural_Anterior
GGCATTGTCTCTAGCC-1	Neural_Anterior
GGCATTGTCTTGGACG-1	Neural_Anterior
GGCCAACTCCAACTGG-1	Neural_Anterior
GGCCAACTCGTTATAG-1	Neural_Posterior
GGCCAACTCTAGCGAT-1	Neural_Posterior
GGCCAACTCTGCAACG-1	Neural_Posterior
GGCCAGTTCCTCACAC-1	Neural_Anterior
GGCCAGTTCGGTACGC-1	Neural_Anterior
GGCCATCAGACAAACG-1	Neural_Anterior
GGCCATCAGAGCCGCT-1	Neural_Anterior
GGCCATCAGCTCAAAC-1	Neural_Anterior
GGCCATCAGTGAGCAA-1	Neural_Anterior
GGCCGTTAGACTTACA-1	Neural_Anterior
GGCCGTTAGCTTTGTT-1	Neural_Posterior
GGCCGTTAGTAATCCA-1	Somites
GGCCTAATCAATACGC-1	Neural_Posterior
GGCCTAATCCCGCCTA-1	Neural_Anterior
GGCCTAATCCTTTACG-1	Neural_Anterior
GGCCTAATCTCAATAG-1	Neural_Anterior
GGCCTCTGTAATAGCT-1	Neural_Anterior
GGCCTCTGTAATGGAA-1	Neural_Posterior
GGCCTCTGTACAATGT-1	Neural_Anterior
GGCCTCTGTTTATCTG-1	Neural_Anterior
GGCCTTAAGAATCTCA-1	Neural_Anterior
GGCCTTAAGCGAGTAA-1	Neural_Anterior
GGCCTTAAGGACGTAA-1	Neural_Anterior
GGCCTTAAGTCATTGA-1	Neural_Anterior
GGCGCTAGTGCTAGAC-1	Neural_Anterior
GGCGCTAGTGCTGGTG-1	Neural_Anterior
GGCGGTAAGTAAGGGC-1	Neural_Anterior
GGCGGTTTCCAGGGAG-1	Neural_Posterior
GGCGGTTTCTTGCTAT-1	Neural_Anterior
GGCGTTATCCACCTGT-1	Neural_Anterior
GGCGTTATCCCTGGTT-1	Neural_Anterior
GGCGTTATCCGCAAAT-1	Neural_Anterior
GGCGTTATCGCGCTAA-1	Neural_Anterior
GGCTAGACAAGCTACC-1	Neural_Anterior
GGCTAGACAATGAATG-1	Neural_Posterior
GGCTAGACAGCCGCTA-1	Neural_Posterior
GGCTAGACAGGATAAC-1	Somites
GGCTAGACATCTAGCA-1	Neural_Posterior
GGCTAGTGTAAATTGC-1	Neural_Posterior
GGCTAGTGTCATGAGC-1	Neural_Anterior
GGCTAGTGTGAAACAA-1	Neural_Anterior
GGCTATGTCTGGTCCT-1	Neural_Posterior
GGCTATTAGGCATGTT-1	Neural_Anterior
GGCTATTAGGTTTGAC-1	Neural_Anterior
GGCTCAATCAGGTCCA-1	Neural_Posterior
GGCTCAATCCCTGGAA-1	Neural_Anterior
GGCTCAATCCTCCTAA-1	Neural_Anterior
GGCTCAATCGGTTTGG-1	Neural_Anterior
GGCTCACAGCCGCTAA-1	Neural_Anterior
GGCTCACAGGCACAGG-1	unassigned
GGCTCACAGGCGAATA-1	Neural_Anterior
GGCTCACAGGTACCGC-1	Neural_Anterior
GGCTGAGAGGACCTCA-1	Neural_Anterior
GGCTGAGAGGAGCAAC-1	Neural_Anterior
GGCTGAGAGGCTACTG-1	Neural_Posterior
GGCTGAGAGTCAATTG-1	Neural_Posterior
GGCTGGTTCATTGACA-1	Neural_Posterior
GGCTGGTTCCTAAGTA-1	Neural_Posterior
GGCTGGTTCGTTTCTG-1	Somites
GGCTGTCAGAAGCTAG-1	Neural_Posterior
GGCTGTCAGCCGCTTT-1	Neural_Anterior
GGCTGTCAGCGAGTAA-1	NMPs
GGCTGTCAGTTTGAGC-1	Neural_Anterior
GGCTTAAGTACTTAGG-1	Neural_Anterior
GGCTTAAGTGTGTGGT-1	Neural_Anterior
GGCTTAAGTTTACCGT-1	Neural_Posterior
GGCTTCAAGCACTAAC-1	Muscle
GGCTTCAAGCGATAAG-1	Neural_Anterior
GGCTTCAAGTCCTGAG-1	Neural_Anterior
GGGAATATCCTTGCGT-1	Neural_Anterior
GGGAATATCGAGCAAA-1	Neural_Posterior
GGGAATATCGCTCCAT-1	Neural_Posterior
GGGAGTAGTAGGTTGC-1	NMPs
GGGAGTAGTCACAGAC-1	Neural_Anterior
GGGAGTAGTCAGGCAT-1	Neural_Anterior
GGGAGTAGTCTATCGT-1	Neural_Anterior
GGGAGTAGTGATTACG-1	Neural_Posterior
GGGAGTAGTTAGCCAA-1	Neural_Posterior
GGGAGTAGTTGGTTCT-1	Neural_Anterior
GGGATAATCCCGAAGC-1	Neural_Posterior
GGGATAATCCGTAAAC-1	Neural_Anterior
GGGATAATCTTGTTCG-1	Neural_Anterior
GGGATTAAGAAAGCAT-1	Neural_Anterior
GGGATTAAGGATGATG-1	Neural_Posterior
GGGATTAAGTATGTGC-1	Neural_Posterior
GGGATTAAGTGAGGGT-1	Neural_Anterior
GGGCAATAGTGTGATC-1	Neural_Posterior
GGGCATGAGGAACCAA-1	Neural_Posterior
GGGCATGAGTTGGATC-1	Neural_Posterior
GGGCATTGTCAAAGGG-1	Somites
GGGCATTGTCGTTATC-1	Neural_Posterior
GGGCCTAGTAATCGGC-1	Neural_Posterior
GGGCCTAGTTAAGCGC-1	Neural_Posterior
GGGCCTAGTTGGTTGA-1	Neural_Posterior
GGGCGAATCTTGATGA-1	Neural_Anterior
GGGCTAACAAAGCCTC-1	Neural_Posterior
GGGCTAACAAAGGTAC-1	Neural_Posterior
GGGCTAACAAGCGATG-1	Neural_Anterior
GGGCTAACACCAGCAT-1	Neural_Anterior
GGGTATTTCAATGACC-1	Neural_Anterior
GGGTATTTCGTGCCTT-1	Neural_Posterior
GGGTATTTCGTTAACA-1	Neural_Posterior
GGGTATTTCTACCTCA-1	Neural_Posterior
GGGTATTTCTTGCAAA-1	Neural_Anterior
GGGTCAACACCTAATG-1	Neural_Anterior
GGGTCAACACCTCGCT-1	Somites
GGGTCAACAGCTAACC-1	Neural_Posterior
GGGTCAACATGCTCCC-1	Muscle
GGGTCACTCGCACACA-1	Somites
GGGTCACTCTTCAATC-1	Neural_Anterior
GGGTGAAGTTGGGTTA-1	Neural_Posterior
GGGTGAAGTTGTGATG-1	Neural_Posterior
GGGTGTTGTCCAAGAC-1	Neural_Posterior
GGGTGTTGTGCGCAAT-1	Somites
GGGTGTTGTGTGTGGT-1	Somites
GGGTGTTGTTGGCCGA-1	Neural_Anterior
GGGTTACGTAACTACG-1	Neural_Anterior
GGGTTACGTGAAACAA-1	Neural_Anterior
GGGTTACGTTACTTGC-1	Neural_Posterior
GGGTTATTCAAGTGAG-1	Neural_Anterior
GGGTTATTCCTCCCTC-1	Neural_Anterior
GGGTTATTCCTCCTAA-1	Neural_Anterior
GGGTTATTCCTGCGAA-1	Somites
GGGTTTCCATGAAGTA-1	Neural_Anterior
GGGTTTGTCCATAAGC-1	Neural_Anterior
GGGTTTGTCCGGTTGA-1	Neural_Anterior
GGGTTTGTCCTCAGTC-1	Neural_Anterior
GGGTTTGTCGGTTACG-1	Neural_Anterior
GGGTTTGTCGTGCCTT-1	Neural_Anterior
GGGTTTGTCTACCTCA-1	Neural_Anterior
GGTAAACCAACCTGGT-1	Neural_Posterior
GGTAAACCACAATGTT-1	Neural_Anterior
GGTAACCGTATTCGCT-1	Neural_Posterior
GGTAACCGTTATCCTA-1	Neural_Posterior
GGTAACTTCACGCATG-1	Neural_Posterior
GGTAACTTCACTTTAC-1	Neural_Anterior
GGTAACTTCATCCTAT-1	NMPs
GGTAACTTCTAGCGAT-1	Neural_Posterior
GGTAAGGGTGAATCGC-1	Neural_Anterior
GGTAAGGGTTCCTGTG-1	Somites
GGTAAGGGTTGAGCCG-1	Neural_Posterior
GGTAAGGGTTTAGCTC-1	Neural_Posterior
GGTAAGGGTTTGCGCC-1	Somites
GGTAATTGTCTCACTG-1	Neural_Anterior
GGTACAAAGATAGACG-1	Neural_Anterior
GGTACAAAGCGCCTAA-1	Neural_Anterior
GGTACAAAGGATAAAC-1	Neural_Posterior
GGTACAAAGTCACCTC-1	Muscle
GGTACCGGTTTGAGCA-1	Neural_Anterior
GGTACTAGTATTTGCC-1	Neural_Posterior
GGTACTAGTCATTAGG-1	Neural_Posterior
GGTACTAGTTGCAGTA-1	Neural_Posterior
GGTACTAGTTGGTTCT-1	Neural_Posterior
GGTACTTAGCAATAGG-1	Neural_Anterior
GGTACTTAGCATTATG-1	Neural_Anterior
GGTAGGAGTTAAATGC-1	Neural_Anterior
GGTAGGAGTTTCCACG-1	Neural_Posterior
GGTATGTTCAATGTCA-1	Neural_Posterior
GGTATGTTCAGGGCCT-1	Neural_Anterior
GGTATGTTCATGACCG-1	Neural_Anterior
GGTATGTTCCCTCTAA-1	Neural_Anterior
GGTATGTTCCGCAAGC-1	Somites
GGTATGTTCCTAATTC-1	Neural_Anterior
GGTATTGGTCTAACAG-1	Neural_Anterior
GGTATTGGTTAATCGG-1	Neural_Anterior
GGTATTTCAACAGCCT-1	Neural_Posterior
GGTATTTCACATAGCC-1	Muscle
GGTATTTCAGCACGAA-1	Neural_Anterior
GGTATTTCAGCTAATT-1	Neural_Anterior
GGTATTTCATAAAGCA-1	Neural_Anterior
GGTCAAGCAAGGAATC-1	Neural_Posterior
GGTCAAGCAATTAGGA-1	Neural_Anterior
GGTCAAGCACAGCCTG-1	Neural_Posterior
GGTCAAGCAGCACGTT-1	Neural_Anterior
GGTCAAGCAGGAAGCC-1	Neural_Anterior
GGTCAAGCATCAGTAT-1	Neural_Posterior
GGTCAAGCATCCCGCT-1	Neural_Anterior
GGTCAAGCATTGTGTG-1	Neural_Anterior
GGTCAATTCGGTCATG-1	Neural_Posterior
GGTCAATTCGGTTACG-1	Neural_Anterior
GGTCAGGAGAGAGCCG-1	Neural_Anterior
GGTCAGGAGCGAGGTG-1	Neural_Anterior
GGTCATTAGCCGCAGT-1	Neural_Anterior
GGTCCATCAACTCGCG-1	Neural_Posterior
GGTCCATCAAGCTTAT-1	Neural_Anterior
GGTCCATCAATCCCTT-1	Neural_Posterior
GGTCCATCACTAAGCC-1	Neural_Posterior
GGTCCGTAGGAACCAA-1	Neural_Posterior
GGTCCGTAGTCACTCC-1	Neural_Anterior
GGTCCGTAGTTCCTCA-1	Neural_Posterior
GGTCCTGCATGCTTAG-1	Neural_Anterior
GGTCGGTTCTTGTCCA-1	Neural_Posterior
GGTCTTGAGCACAGGG-1	Neural_Posterior
GGTCTTGAGGGATTAG-1	Neural_Anterior
GGTCTTGAGGGCTTTG-1	Neural_Anterior
GGTCTTGAGTGCACGC-1	Neural_Anterior
GGTCTTGAGTTCCTCA-1	Neural_Posterior
GGTCTTTGTTCACTGT-1	Neural_Anterior
GGTCTTTGTTCCATTA-1	Neural_Anterior
GGTCTTTGTTGCAATG-1	Neural_Anterior
GGTGAGCCACCTACTT-1	unassigned
GGTGAGCCAGCTAATT-1	Neural_Posterior
GGTGAGGTCATTACGA-1	Neural_Posterior
GGTGAGGTCCGCCAAA-1	Neural_Anterior
GGTGAGGTCCTTCTAG-1	Neural_Anterior
GGTGAGGTCGGTTAGT-1	Neural_Posterior
GGTGAGGTCTCACATT-1	Neural_Anterior
GGTGAGGTCTGTGAGT-1	Neural_Posterior
GGTGAGTAGCAGCTAT-1	Neural_Anterior
GGTGATTTCAATCATG-1	Muscle
GGTGATTTCACTCGCT-1	Neural_Anterior
GGTGATTTCCGCTAGA-1	Neural_Posterior
GGTGATTTCCTTGCAC-1	Neural_Anterior
GGTGCTGGTGTAATAC-1	Neural_Posterior
GGTGCTTCAGCTTAGC-1	Neural_Anterior
GGTGCTTCAGGCAAGC-1	Neural_Anterior
GGTGCTTCAGTCTAAT-1	Neural_Posterior
GGTGTCCAGCGTGCAC-1	Neural_Anterior
GGTGTCCAGGTCCAAT-1	Neural_Anterior
GGTGTCCAGGTCGATT-1	Neural_Anterior
GGTGTCCAGTGGACAA-1	Neural_Anterior
GGTGTGACAGCATGTC-1	Neural_Anterior
GGTGTTGTCAAGCTAC-1	Neural_Anterior
GGTGTTGTCACAGACT-1	Neural_Anterior
GGTGTTGTCCAAGTGT-1	Neural_Posterior
GGTTAATGTAGGATTT-1	Neural_Posterior
GGTTAATGTCAATAGT-1	Neural_Anterior
GGTTAATGTGATCAGC-1	Neural_Anterior
GGTTAATGTTATCCGT-1	Neural_Posterior
GGTTACCCACAAAGGT-1	Neural_Anterior
GGTTACCCACCGTTCC-1	Neural_Anterior
GGTTACCCATGAGCAG-1	Neural_Posterior
GGTTACTAGTAGCGCC-1	Neural_Anterior
GGTTAGCGTAGTTACG-1	Neural_Anterior
GGTTAGCGTTCGGGAT-1	Neural_Anterior
GGTTAGCGTTTGCAGA-1	Neural_Posterior
GGTTATATCAAGCTTA-1	Neural_Anterior
GGTTATATCATGCTCC-1	Neural_Anterior
GGTTATATCATTACAG-1	Neural_Anterior
GGTTATATCCGCACAA-1	Neural_Posterior
GGTTATATCCGGTTGA-1	Neural_Anterior
GGTTATATCCTAGTTT-1	Neural_Anterior
GGTTATATCCTGGTGA-1	Neural_Anterior
GGTTATATCTGTTGCC-1	Neural_Anterior
GGTTATGGTCACAAAT-1	Neural_Posterior
GGTTATGGTCGTTACT-1	Neural_Posterior
GGTTATGGTTATGTGG-1	Neural_Anterior
GGTTATGGTTCCAGGG-1	Neural_Posterior
GGTTCCCGTGCCGCAA-1	Neural_Posterior
GGTTCCCGTGGAGCAA-1	Neural_Posterior
GGTTCTTGTCAACAAT-1	Neural_Posterior
GGTTCTTGTCATAAGT-1	Neural_Anterior
GGTTCTTGTCCCGGAA-1	Neural_Posterior
GGTTCTTGTCTTGCAT-1	Neural_Posterior
GGTTCTTGTGCTTAGA-1	Neural_Anterior
GGTTGACGTCAGGCAT-1	Neural_Anterior
GGTTGACGTCATCATC-1	Neural_Anterior
GGTTGACGTGTTTGTC-1	Neural_Anterior
GGTTGACGTTTCCTCC-1	Neural_Posterior
GGTTGAGCAAATATCC-1	Neural_Anterior
GGTTGAGCAACCGCCA-1	Neural_Posterior
GGTTGAGCAAGGTGGC-1	Neural_Anterior
GGTTGAGCAGGCTTCG-1	Neural_Anterior
GGTTGAGCAGGTTTGC-1	Neural_Posterior
GGTTGCATCAAGTGTC-1	Neural_Anterior
GGTTGCATCAATGTGC-1	Neural_Anterior
GGTTGCATCACAGCCA-1	Neural_Posterior
GGTTGCATCATAGACC-1	Muscle
GGTTGCATCATTGTCT-1	Neural_Anterior
GGTTGCATCGAAGTAG-1	Neural_Posterior
GGTTGCATCGTGCTAG-1	Neural_Posterior
GGTTGCATCTAGCTTT-1	Neural_Posterior
GGTTGCGGTAACGAGG-1	Neural_Anterior
GGTTGCGGTAGCTGGT-1	Neural_Anterior
GGTTGCGGTGGTTATG-1	Neural_Posterior
GGTTGCGGTGTTTGTC-1	Neural_Anterior
GGTTGCTCAAGGAATC-1	Neural_Anterior
GGTTGCTCATTGCGTA-1	Neural_Posterior
GGTTGGTGTAGGTTGC-1	Neural_Anterior
GGTTGGTGTGGGTGAA-1	Neural_Posterior
GGTTTAATCACTAAGC-1	Neural_Anterior
GGTTTAATCCGTGACA-1	Neural_Posterior
GGTTTAATCCTTGAGG-1	Neural_Anterior
GGTTTCCTCAGGCCTA-1	Neural_Posterior
GGTTTCCTCATCGTTT-1	Neural_Posterior
GGTTTCCTCATTACGA-1	Neural_Anterior
GGTTTCTGTCAAGTAT-1	Neural_Posterior
GGTTTCTGTCGACTAA-1	Neural_Anterior
GGTTTCTGTTATCCGT-1	Neural_Posterior
GGTTTCTGTTCCAGGG-1	Somites
GGTTTGTAGAATCTCA-1	Neural_Posterior
GGTTTGTAGACACCGC-1	Neural_Anterior
GGTTTGTAGGACCGCT-1	Neural_Anterior
GGTTTGTAGGGATGCG-1	Neural_Anterior
GGTTTGTAGGTCCGTA-1	Neural_Anterior
GTAAAGCCAAGCTTTG-1	Neural_Anterior
GTAAAGCCAATTAACC-1	Neural_Posterior
GTAAAGCCATAGCTGC-1	Neural_Anterior
GTAAGCAAGGACAATG-1	Neural_Anterior
GTAAGCGCAAGTGTCC-1	Neural_Anterior
GTAAGCGCATGACTAT-1	Neural_Anterior
GTAAGCTTCAGCCAAT-1	Neural_Anterior
GTAAGCTTCAGTATTG-1	Neural_Posterior
GTAAGGTCAAGTAAGC-1	Muscle
GTAAGGTCAATTAACC-1	Neural_Anterior
GTAAGGTCAGGCTTGT-1	Neural_Anterior
GTAATAGCACAAAGAC-1	Neural_Posterior
GTAATAGCAGCATGTC-1	Neural_Posterior
GTAATAGCAGGATGGC-1	Neural_Posterior
GTACAATGTACCAGGT-1	Neural_Anterior
GTACAATGTGAGCACT-1	Neural_Anterior
GTACAATGTGCGCAAT-1	Neural_Anterior
GTACAATGTGGAGCAA-1	Somites
GTACAATGTGGCTTCC-1	Neural_Posterior
GTACAATGTTAGCAGC-1	Neural_Anterior
GTACCTTGTACCGTTT-1	Neural_Anterior
GTACCTTGTAGGATTT-1	Neural_Anterior
GTACCTTGTGCAATGC-1	Neural_Posterior
GTACCTTGTGTCACGG-1	Neural_Posterior
GTACCTTGTTGGTTGA-1	Neural_Posterior
GTACGTAGTAATCCCT-1	Neural_Anterior
GTACGTAGTCCTTAGT-1	Neural_Anterior
GTACGTAGTGGTTCTT-1	Neural_Anterior
GTACTAATCAGCAAAG-1	Neural_Anterior
GTACTAATCATGGTGT-1	Neural_Posterior
GTACTAATCCACAATA-1	Neural_Anterior
GTACTAATCCTCCTAA-1	Neural_Anterior
GTACTAATCTTGAGCG-1	Muscle
GTACTTAAGGCTACTG-1	Neural_Anterior
GTACTTCGTAAGGTCC-1	Neural_Posterior
GTACTTCGTCAGGAAG-1	Neural_Anterior
GTACTTCGTGCACGCA-1	Neural_Anterior
GTACTTCGTGCTAGCG-1	Neural_Posterior
GTACTTCGTGTGCAAC-1	Neural_Anterior
GTAGCCATCACGCCAA-1	Neural_Posterior
GTAGCCATCATGTTTC-1	Neural_Anterior
GTAGCCATCATTACAG-1	Neural_Anterior
GTAGCCATCTGGCTTC-1	Neural_Anterior
GTAGCGCTCAGTTCCC-1	Neural_Posterior
GTAGCGCTCGGTAACT-1	Muscle
GTAGCTGTCAAGACTC-1	Neural_Anterior
GTAGCTGTCGTACCGA-1	Neural_Anterior
GTAGGAGGTCAACAAT-1	Neural_Anterior
GTAGGAGGTGGGTGAA-1	Neural_Posterior
GTAGGATCAAAGCGGC-1	Neural_Posterior
GTAGGATCATCCGTAA-1	Neural_Anterior
GTAGGCGAGTTTGCGG-1	Neural_Anterior
GTAGGTGCAACAGGTG-1	Neural_Anterior
GTAGGTGCAAGCCACT-1	Neural_Posterior
GTAGGTGCAAGCTACC-1	Neural_Anterior
GTAGGTGCACTCAACA-1	Somites
GTAGGTGCAGCCTAAC-1	Neural_Anterior
GTAGGTGCATTGTCCT-1	Neural_Anterior
GTAGTTTCAACAGCCT-1	Neural_Anterior
GTAGTTTCACACCAAC-1	Neural_Anterior
GTATCGCCAATATAGG-1	Neural_Anterior
GTATCGCCATGGCCTG-1	Neural_Posterior
GTATGTGGTCACGGAT-1	Neural_Anterior
GTATGTGGTCCCGAAG-1	Neural_Anterior
GTATGTGGTTAAGCCA-1	Neural_Anterior
GTATGTGGTTCTTTAG-1	Neural_Anterior
GTATGTTCAAAGCTCC-1	Neural_Anterior
GTATGTTCAATTTGGT-1	Neural_Anterior
GTATGTTCATTGCAGC-1	Neural_Anterior
GTATTCAAGTCATCCC-1	Neural_Posterior
GTATTCAAGTCATGCG-1	Neural_Anterior
GTATTGATCAAAGGCA-1	Neural_Anterior
GTATTGATCGCTAGAT-1	Neural_Posterior
GTATTGCAGCGCCTTT-1	Muscle
GTATTGCAGCGTGCAC-1	Neural_Anterior
GTATTGTCAGGTTATT-1	Neural_Anterior
GTCAAACTCACAGCCA-1	Neural_Anterior
GTCAAACTCATGTGGT-1	Neural_Posterior
GTCAAACTCCCTTGCG-1	Neural_Posterior
GTCAAACTCGGTCATG-1	Neural_Anterior
GTCAAACTCGGTTTCC-1	Neural_Anterior
GTCAAACTCTGCAAGT-1	Neural_Posterior
GTCAATATCCTAGTTT-1	Neural_Anterior
GTCAATATCTACTAAG-1	Neural_Anterior
GTCAGGCTCATCGTTT-1	Muscle
GTCAGGCTCCTAATAG-1	Neural_Posterior
GTCAGGCTCTTTAAGG-1	Neural_Posterior
GTCATCACAGGCTTCG-1	Neural_Anterior
GTCATCCTCATGGTGT-1	Neural_Posterior
GTCATCCTCCCTGACT-1	Neural_Anterior
GTCATCCTCTAACCAA-1	Neural_Anterior
GTCATGAGTACTGATG-1	Somites
GTCCAAGTCTTAGGAC-1	Neural_Anterior
GTCCAGGGTAAGCTCA-1	Neural_Anterior
GTCCAGGGTGACATAT-1	Muscle
GTCCAGGGTTCCGGGA-1	Neural_Anterior
GTCCAGGGTTCCTGAT-1	Neural_Posterior
GTCCATTGTCCTAAGA-1	Neural_Anterior
GTCCATTGTTCGCTCA-1	Neural_Posterior
GTCCGTAAGGCAACAA-1	Neural_Posterior
GTCCTAGAGACTAAGG-1	Neural_Posterior
GTCCTAGAGATTGAGG-1	Neural_Anterior
GTCCTCAGTTTAACCC-1	Neural_Posterior
GTCCTCCCAGGATAAC-1	Neural_Anterior
GTCCTCCCATGCTTAG-1	Neural_Posterior
GTCGAAGCAACAGGTG-1	Neural_Posterior
GTCGAAGCAGATAGAC-1	Neural_Anterior
GTCGAAGCAGGAATCG-1	Neural_Posterior
GTCGAAGCATAAAGCA-1	Neural_Anterior
GTCGAAGCATCCCGCT-1	Neural_Posterior
GTCGAGGAGGACCGCT-1	Neural_Anterior
GTCGAGGAGGCAACAA-1	Neural_Anterior
GTCGAGGAGGTTTACA-1	Neural_Anterior
GTCGAGGAGGTTTGAC-1	Neural_Posterior
GTCGCAATCCTTCAAT-1	Neural_Posterior
GTCGCAATCGCCTAAG-1	Neural_Posterior
GTCGCAATCGTTTCCA-1	Neural_Anterior
GTCGCAATCTTACTCG-1	Neural_Anterior
GTCGGTTCAACTCGCG-1	Neural_Anterior
GTCGGTTCAAGGTATA-1	Neural_Posterior
GTCGGTTCAGGATAAC-1	Neural_Anterior
GTCTAATCAGCAAATA-1	Neural_Anterior
GTCTAATCATTATCCC-1	Neural_Anterior
GTCTAGCCACAACAAA-1	Neural_Anterior
GTCTAGCCACGTTACA-1	Neural_Posterior
GTCTAGCCAGGTTAAA-1	Neural_Posterior
GTCTATCGTAGCCTCC-1	Somites
GTCTATCGTGCTGTAA-1	Neural_Anterior
GTCTATCGTGTGTGGT-1	Neural_Anterior
GTCTATGCAGCTTAAT-1	Neural_Anterior
GTCTATGCATGGTTAT-1	unassigned
GTCTCACTCACATTGA-1	Neural_Posterior
GTCTCACTCCCTCAGT-1	Neural_Anterior
GTCTCACTCCTTAAGA-1	Neural_Anterior
GTCTCACTCGCATTAA-1	Neural_Anterior
GTCTCACTCTGCAAGT-1	Neural_Posterior
GTCTTGCTCCAAGTGT-1	Neural_Posterior
GTCTTGCTCCACCTGT-1	Neural_Anterior
GTCTTGCTCTGCAAAC-1	Neural_Anterior
GTCTTTAGTGACATGC-1	Neural_Posterior
GTCTTTAGTGGATTCA-1	Neural_Anterior
GTCTTTGTCAGCAAAG-1	Neural_Anterior
GTGAACAAGCCTCTGT-1	Neural_Posterior
GTGAACAAGCGGCTGT-1	Neural_Posterior
GTGAACAAGCTCAATA-1	Neural_Posterior
GTGAACAAGGACCGCT-1	Neural_Anterior
GTGAACAAGTTTGCGG-1	Neural_Posterior
GTGAATCTCATAGCCG-1	Neural_Posterior
GTGAATCTCCGCCAAA-1	Neural_Posterior
GTGAATCTCCGCCTCA-1	Neural_Posterior
GTGAATCTCGCTCACT-1	Neural_Posterior
GTGAGCGAGATAACCC-1	Neural_Posterior
GTGAGGAGTGAACAAA-1	Neural_Anterior
GTGAGGAGTTTGTTGC-1	Neural_Anterior
GTGATCAGTAGCTAGC-1	Neural_Anterior
GTGATCAGTGTCCAGG-1	Neural_Anterior
GTGATCAGTTGGTGAC-1	Neural_Anterior
GTGATCAGTTGGTTCT-1	Neural_Anterior
GTGATGAAGGAGGGTT-1	Neural_Anterior
GTGATGAAGGTCCTGA-1	Neural_Posterior
GTGATGAAGTTACTTC-1	Neural_Anterior
GTGATGAAGTTAGCTA-1	Neural_Anterior
GTGCAAGCAATAACCT-1	Neural_Anterior
GTGCACGGTCCGTGAG-1	Neural_Posterior
GTGCACGGTGATTACG-1	Neural_Anterior
GTGCACGGTGCACGCA-1	Neural_Posterior
GTGCATTAGCGCTAAT-1	Neural_Posterior
GTGCATTAGGTCATTA-1	Neural_Posterior
GTGCATTAGTTAGGCT-1	Neural_Anterior
GTGCATTAGTTCCTGC-1	Neural_Posterior
GTGCCTTTCACAGGAA-1	Neural_Anterior
GTGCCTTTCCACCTGT-1	Neural_Anterior
GTGCGCAGTTATAGCG-1	Neural_Anterior
GTGCGCAGTTGCACAA-1	Neural_Posterior
GTGCGGTTCACGCATG-1	Neural_Anterior
GTGCGGTTCATGCCTC-1	Neural_Posterior
GTGCTCAAGCATTAGC-1	Neural_Posterior
GTGCTCAAGCTGTCAG-1	Neural_Anterior
GTGCTCCGTGCACGCA-1	Neural_Anterior
GTGCTCCGTGGGTGAA-1	Neural_Anterior
GTGCTGATCACAGGAA-1	Neural_Posterior
GTGCTGATCATTAGCA-1	Neural_Posterior
GTGCTGATCCGCACAA-1	Neural_Anterior
GTGCTGATCCTCACAC-1	Neural_Anterior
GTGCTGGGTAAAGCAA-1	Neural_Anterior
GTGCTGGGTCACAAAT-1	Neural_Anterior
GTGCTGGGTCATGCCC-1	Neural_Anterior
GTGCTGGGTGTTGTAG-1	Neural_Posterior
GTGCTGGGTTAGCGTA-1	Neural_Anterior
GTGCTTACAGGCGAGT-1	Neural_Posterior
GTGCTTACATCTAGCA-1	Neural_Posterior
GTGCTTCTCGTTCACC-1	Neural_Anterior
GTGGACACAAGCGATG-1	unassigned
GTGGACACAGCTAACC-1	Neural_Posterior
GTGGATGCAAACAACA-1	Neural_Anterior
GTGGATGCACGGTACT-1	Neural_Posterior
GTGGATGCAGGTTACC-1	Neural_Posterior
GTGGCTTCAGGGAGGA-1	Neural_Posterior
GTGGCTTCATTAGCCA-1	Neural_Anterior
GTGGCTTCATTGTTGG-1	Neural_Posterior
GTGGTTAGTTGCAGTA-1	Neural_Anterior
GTGTAACTCATTAGGC-1	Somites
GTGTAACTCCACCTGT-1	Neural_Anterior
GTGTAACTCTGGCTTC-1	Neural_Posterior
GTGTCCAAGCCTGTTC-1	Neural_Posterior
GTGTGAGCAAGGTAAC-1	Neural_Anterior
GTGTGCGGTAGGATTT-1	Neural_Anterior
GTGTGCGGTCGACTCC-1	Neural_Anterior
GTGTGTTAGCGGCTGT-1	Neural_Anterior
GTGTTCCTCCTAGTAA-1	Muscle
GTTAAACGTCAGGCAT-1	Neural_Anterior
GTTAAACGTCATAAGT-1	Neural_Anterior
GTTAAACGTCCGGTTC-1	Neural_Anterior
GTTAACGGTCATTGAG-1	Neural_Anterior
GTTAAGTGTTTAACGG-1	Neural_Anterior
GTTAATGTCAATGTGC-1	Neural_Anterior
GTTAATGTCCCTGGAA-1	Neural_Posterior
GTTAATGTCCCTGGTT-1	Neural_Anterior
GTTAATGTCCTTTACG-1	Neural_Anterior
GTTAATGTCGTTACTT-1	Somites
GTTACAGGTAAAGCGG-1	Neural_Anterior
GTTACAGGTATTTGGG-1	Neural_Posterior
GTTACAGGTTCTTTAG-1	Neural_Anterior
GTTACCTGTAAGCTCA-1	Neural_Posterior
GTTACCTGTCCGGTTC-1	Neural_Anterior
GTTACCTGTCCTTAGT-1	Neural_Anterior
GTTACCTGTGTTGTGA-1	Neural_Posterior
GTTACCTGTTACCTGT-1	Neural_Anterior
GTTACGCCAAATACCT-1	Neural_Anterior
GTTACGCCAACCGCCA-1	Neural_Anterior
GTTACGCCAAGGTGCA-1	Neural_Anterior
GTTACGTAGCAAGATG-1	Neural_Anterior
GTTACGTAGGAGGTTA-1	Neural_Posterior
GTTACTAAGGCATGAA-1	Neural_Anterior
GTTACTCGTGAGCAAG-1	Neural_Posterior
GTTACTCGTGTTAAAC-1	Neural_Posterior
GTTAGACTCCTTAATC-1	Neural_Anterior
GTTAGACTCGAAGTAG-1	Somites
GTTAGGCGTAAAGCGG-1	Neural_Posterior
GTTAGGCGTCACCAAA-1	Neural_Anterior
GTTAGGCGTCTTACTA-1	Neural_Posterior
GTTAGGCGTGCACGCA-1	Neural_Anterior
GTTAGGCGTGCATTTC-1	Neural_Anterior
GTTCACCTCATCGTTT-1	Neural_Anterior
GTTCACCTCCTGAGTG-1	Neural_Anterior
GTTCACCTCTAATCTC-1	Neural_Anterior
GTTCATTTCATTACTC-1	Neural_Anterior
GTTCATTTCTGGCATG-1	Neural_Anterior
GTTCCCAGTGGGTGAA-1	Neural_Posterior
GTTCCTGGTAACCACA-1	Neural_Posterior
GTTCCTGGTACGATTG-1	Neural_Posterior
GTTCCTGGTAGGTTAT-1	Neural_Anterior
GTTCCTGGTCCGTAGG-1	Neural_Posterior
GTTCCTGGTTAGGACC-1	Neural_Anterior
GTTCCTGGTTCCTGTG-1	Neural_Anterior
GTTCCTTCAATTGAAG-1	Neural_Posterior
GTTCCTTCAGCAGGTA-1	Neural_Posterior
GTTCCTTCATTGTCAG-1	Muscle
GTTCGCGCAAACGGGC-1	Neural_Anterior
GTTCGCGCACTTAACG-1	Neural_Posterior
GTTCGCGCAGCTTAAT-1	Neural_Anterior
GTTCGCTTCTTGATGA-1	Neural_Anterior
GTTCTCATCACCAATA-1	Neural_Posterior
GTTCTTAGTAATCGTG-1	Neural_Anterior
GTTCTTAGTAGCTAGC-1	Neural_Posterior
GTTCTTGTCAATGAGG-1	Neural_Posterior
GTTGCCCGTTAGACCA-1	Neural_Posterior
GTTGCCCGTTCATTTG-1	Neural_Anterior
GTTGCTGAGAGGATAT-1	Neural_Anterior
GTTGCTGAGCTACTGG-1	Neural_Posterior
GTTGCTGAGGACCTCA-1	Neural_Anterior
GTTGGAGCAGCCAGAA-1	Neural_Posterior
GTTGGAGCATGAAATG-1	Neural_Anterior
GTTGGAGCATGAATCT-1	Neural_Anterior
GTTGGAGCATTAGGTT-1	Neural_Posterior
GTTGGCCAGGCGCTAC-1	Neural_Posterior
GTTGGCCAGGGACCTC-1	Neural_Anterior
GTTGGCCAGGTTACGT-1	Muscle
GTTGGCCAGTAGAGGC-1	Somites
GTTGGCGGTCAGGAAG-1	Neural_Anterior
GTTGGCGGTCCTTAGT-1	Neural_Anterior
GTTGGCGGTTACCGGG-1	Neural_Anterior
GTTGTGAGTGCTCACC-1	Neural_Anterior
GTTGTGAGTTGGGTTA-1	Neural_Anterior
GTTGTTGCATCCATCT-1	Neural_Posterior
GTTGTTGCATGCAACC-1	Neural_Posterior
GTTGTTGCATTAGCCA-1	Neural_Posterior
GTTTAACCACCCACCT-1	Neural_Anterior
GTTTACCGTTCCTGTG-1	Neural_Anterior
GTTTACCGTTGAGCCG-1	Neural_Posterior
GTTTAGCAGCGTGCGT-1	Neural_Posterior
GTTTAGCAGGTTTACA-1	Muscle
GTTTATCTCCTGATGG-1	Neural_Anterior
GTTTCAGCAAACTAAG-1	Neural_Anterior
GTTTCAGCACAACCTA-1	Neural_Posterior
GTTTCCTCAGGACCAA-1	Neural_Posterior
GTTTCCTCATCAATCG-1	Neural_Anterior
GTTTCTAGTACGCGCA-1	Neural_Anterior
GTTTCTAGTTGTTCAC-1	Neural_Anterior
GTTTGCTGTGTTTGTC-1	Neural_Anterior
GTTTGTAAGCTATTGA-1	Neural_Anterior
GTTTGTAAGTAACGAG-1	Neural_Anterior
GTTTGTAAGTTGTCAA-1	Neural_Anterior
GTTTGTCGTAATGACT-1	Neural_Anterior
GTTTGTCGTGCTAGAC-1	Neural_Posterior
GTTTGTCGTTAGAGGG-1	Neural_Anterior
GTTTGTCGTTGCAATG-1	Neural_Anterior
TAAACAGCATTATGAC-1	NMPs
TAAAGCCTCCACCTGT-1	Neural_Posterior
TAAAGCCTCCTGGCTT-1	Neural_Anterior
TAACAAGCAATTTAGC-1	Neural_Posterior
TAACAAGCAGGCGAGT-1	Neural_Anterior
TAACCAGGTCATCAAG-1	Muscle
TAACCAGGTCGTTACT-1	Neural_Anterior
TAACCAGGTTGGATAT-1	NMPs
TAACCGGTCAAACCTA-1	Neural_Posterior
TAACCGGTCCTAATAG-1	Neural_Posterior
TAACCGGTCGCATTAA-1	Neural_Anterior
TAACCTAAGAATCTCA-1	Neural_Anterior
TAACCTAAGCGTGCAC-1	Neural_Posterior
TAAGCCAGTCTAGCTT-1	Neural_Posterior
TAAGCCAGTGTCCTGC-1	Neural_Posterior
TAAGCCTAGGCGGATG-1	Neural_Anterior
TAAGCTATCCATAATG-1	Neural_Anterior
TAAGCTATCCCATAGG-1	Neural_Anterior
TAAGCTATCGAGGAAC-1	Muscle
TAAGCTATCGAGGTGG-1	Somites
TAAGCTGGTAGCTAGC-1	Neural_Anterior
TAAGCTGGTCTAACAG-1	Neural_Posterior
TAAGCTGGTGACATGC-1	Neural_Anterior
TAAGGACCAAACGGGC-1	Neural_Posterior
TAAGGACCAGAAATTG-1	Neural_Anterior
TAAGGACCATGAATAG-1	Neural_Posterior
TAAGGCTTCATGGCCA-1	Neural_Anterior
TAAGGCTTCCGGTTAG-1	Neural_Anterior
TAAGGCTTCTTGTCCA-1	Neural_Posterior
TAAGTAGCAAACTCAT-1	Neural_Anterior
TAAGTAGCAATACTGT-1	Neural_Anterior
TAAGTAGCAATATAGG-1	Neural_Anterior
TAAGTAGCAGCAAGAT-1	Neural_Anterior
TAAGTAGCAGGCGATA-1	Neural_Posterior
TAAGTGCTCACTTCAT-1	NMPs
TAAGTGCTCATCGTTT-1	Neural_Anterior
TAATCACCAAAGCCTC-1	Neural_Anterior
TAATCACCACAACAGG-1	Neural_Anterior
TAATCACCACTAAGAA-1	Neural_Anterior
TAATCACCAGTGAACG-1	Neural_Posterior
TAATCACCATGAGTTT-1	Neural_Posterior
TAATCACCATGTCGCG-1	Neural_Anterior
TAATCCGCACCGGCTA-1	Neural_Anterior
TAATGCATCGGTTAGT-1	Neural_Posterior
TAATGGACAGCTTACA-1	Neural_Anterior
TAATGGTGTATACTGG-1	Neural_Posterior
TAATGGTGTCATGCCC-1	Neural_Posterior
TAATGGTGTTGAGGTC-1	Neural_Anterior
TAATGGTGTTTATCGC-1	Neural_Posterior
TAATTGCCATTGGGAG-1	Neural_Anterior
TACAACATCATCACTT-1	Neural_Posterior
TACAACATCCTAGTTT-1	Neural_Posterior
TACAAGCTCACTAGGT-1	Neural_Anterior
TACAATGTCATTTAGG-1	Neural_Anterior
TACAATGTCTTTGACT-1	Neural_Posterior
TACAGCTAGGAACCGG-1	Neural_Anterior
TACAGCTAGGCTTAAC-1	Neural_Anterior
TACATCAAGCATGAAG-1	Neural_Posterior
TACATCAAGTAACGAG-1	Neural_Anterior
TACCAAATCATAACCA-1	Neural_Anterior
TACCAAATCCTAGTTT-1	Neural_Posterior
TACCAAATCCTTGCAC-1	Neural_Anterior
TACCAAATCTGTAATG-1	Neural_Posterior
TACCCGGCACTAAGTT-1	Neural_Anterior
TACCCGGCATGAGCAG-1	Neural_Anterior
TACCGAAGTGGATTAT-1	Neural_Anterior
TACCGCAAGCCTGATG-1	Neural_Anterior
TACCGTTGTTAGGTTG-1	Neural_Posterior
TACCTCATCGATTTAG-1	Neural_Anterior
TACCTCATCGTTTCCA-1	Neural_Anterior
TACCTGCTCAGGCTAT-1	Neural_Posterior
TACCTGCTCTTGCAAA-1	Neural_Posterior
TACCTTAGTCCAAGAC-1	Neural_Posterior
TACCTTAGTGGACCTG-1	Neural_Anterior
TACCTTTAGGATCACT-1	Neural_Anterior
TACCTTTAGTGAGGGT-1	Neural_Anterior
TACGCACCAATATACC-1	Neural_Anterior
TACGCACCATGTCAAT-1	Neural_Anterior
TACGCTTGTAATTAGC-1	Neural_Anterior
TACGCTTGTCCTAAGA-1	Neural_Anterior
TACGGATTCCGCCAAA-1	Neural_Anterior
TACGGATTCTCACATT-1	Neural_Anterior
TACGGATTCTGCAAAC-1	Neural_Anterior
TACGGTTAGCTAAGTC-1	Neural_Anterior
TACGGTTAGCTATGAC-1	Neural_Posterior
TACGGTTAGTCACCTC-1	Neural_Anterior
TACGTAATCACAAGCT-1	Neural_Posterior
TACGTAATCCAGGTCA-1	Neural_Anterior
TACGTAATCCTGGCTT-1	Neural_Posterior
TACGTAATCGCAGGCT-1	unassigned
TACGTAATCTGGCTTC-1	Neural_Anterior
TACGTACAGGTTACAC-1	Muscle
TACGTTAAGACAACGA-1	Neural_Posterior
TACGTTAAGCTTAACA-1	Neural_Posterior
TACGTTAAGTTTCCTG-1	NMPs
TACTAAGTCCCGCCTA-1	Neural_Posterior
TACTAAGTCCTAGTAA-1	Neural_Anterior
TACTAAGTCGATAACC-1	Neural_Anterior
TACTAAGTCTCAATGA-1	Somites
TACTCAAAGTTCCCGT-1	Neural_Anterior
TACTCGCTCCTAATTC-1	Neural_Anterior
TACTGACAGCCTGTGA-1	Neural_Posterior
TACTGAGGTACAAAGA-1	Neural_Posterior
TACTGAGGTTTCGCGC-1	Neural_Anterior
TACTGCACATAATGTC-1	Neural_Posterior
TACTGCACATCGCTTT-1	Neural_Anterior
TACTGGCCAGTGAACG-1	Neural_Anterior
TACTTCGTCATGGTTA-1	Neural_Anterior
TACTTCGTCGTGCTAG-1	Neural_Anterior
TACTTGTTCAAGGACA-1	Neural_Anterior
TACTTGTTCTGGCATG-1	Neural_Posterior
TACTTGTTCTGTTGCC-1	Neural_Anterior
TAGACCAGTTAGGCTA-1	Neural_Anterior
TAGACCAGTTCGGGAT-1	Neural_Anterior
TAGACCAGTTTGAGGC-1	Neural_Anterior
TAGAGCCGTAATTAGC-1	Neural_Anterior
TAGAGCCGTATTGAGT-1	Neural_Posterior
TAGAGCCGTGTCCAGG-1	Neural_Anterior
TAGAGCCGTTCGCTCA-1	Neural_Anterior
TAGAGCCGTTTACGTC-1	Neural_Anterior
TAGCAGGCATGCTTAG-1	Neural_Posterior
TAGCATATCGATTTAG-1	Somites
TAGCATATCTTGATGA-1	Neural_Posterior
TAGCCGGGTAATCCCT-1	Neural_Posterior
TAGCCGGGTGAACAAA-1	Somites
TAGCCGGGTTAGTGAT-1	Neural_Posterior
TAGCCTCTCAGGATGA-1	Neural_Anterior
TAGCCTCTCTTAATGG-1	Neural_Anterior
TAGCCTGAGCGCATTG-1	Neural_Anterior
TAGCCTTGTGGACCTG-1	Neural_Anterior
TAGCCTTGTTGAATCG-1	Neural_Anterior
TAGCGCGGTCCTTCAG-1	Neural_Anterior
TAGCGGACAAACGCGA-1	Neural_Posterior
TAGCGGCTCCACAATA-1	Neural_Anterior
TAGCGGCTCGTTTCGC-1	Neural_Anterior
TAGCGGCTCTTGTTCG-1	Neural_Posterior
TAGCTAATCATGGTTA-1	Neural_Anterior
TAGCTAATCCCGTTAC-1	Neural_Anterior
TAGCTAATCTAAATCG-1	Neural_Anterior
TAGCTAATCTCACTAT-1	Neural_Posterior
TAGCTAATCTTAAGTG-1	Neural_Posterior
TAGCTAGGTTCCGGCT-1	Neural_Anterior
TAGCTTAAGCATCCAG-1	Neural_Posterior
TAGCTTGCACAATGTT-1	Neural_Anterior
TAGCTTGCACAGCCAT-1	Somites
TAGCTTGCACCTACGG-1	Neural_Anterior
TAGCTTGCACTAGCGT-1	Neural_Anterior
TAGGAACCAATTAGCT-1	Neural_Anterior
TAGGAACCACAACAAA-1	Neural_Anterior
TAGGAACCACCCTCAC-1	Neural_Anterior
TAGGAACCACGAATTT-1	Neural_Posterior
TAGGAACCAGCCTTGG-1	Neural_Anterior
TAGGAACCATTAGGTT-1	Neural_Posterior
TAGGAGGGTGCTGTAA-1	Neural_Posterior
TAGGAGGGTGTTTCAC-1	Neural_Posterior
TAGGAGTCAATAACGA-1	Neural_Anterior
TAGGAGTCAGCATTAT-1	Neural_Anterior
TAGGAGTCATAAACCT-1	Neural_Posterior
TAGGCTAGTAATCACG-1	Neural_Posterior
TAGGCTAGTCACAAAT-1	Neural_Anterior
TAGGCTAGTCATAAGT-1	Neural_Anterior
TAGGCTAGTTCACTGT-1	Neural_Anterior
TAGGCTGTCGGTCAGC-1	Neural_Posterior
TAGGCTTAGGCTACAT-1	Neural_Anterior
TAGGGTTTCATGGCTG-1	Neural_Anterior
TAGGGTTTCGCAACAT-1	Neural_Anterior
TAGGGTTTCGCTAGTG-1	Neural_Posterior
TAGGGTTTCGTTACAA-1	Neural_Anterior
TAGGGTTTCGTTTCGC-1	Neural_Anterior
TAGGTGCGTCACGAAC-1	Neural_Posterior
TAGGTGCGTCCACAAA-1	Neural_Anterior
TAGGTGCGTCTAACCT-1	Neural_Anterior
TAGGTGCGTTTATCTG-1	Neural_Anterior
TAGGTTATCAATGACC-1	Neural_Anterior
TAGGTTATCCTAACGG-1	Neural_Anterior
TAGGTTATCGTTAACA-1	Neural_Posterior
TAGGTTATCTCATCAT-1	Neural_Anterior
TAGGTTGGTTGAGGTC-1	Neural_Anterior
TAGGTTGGTTGTTGGA-1	Neural_Posterior
TAGTAACGTCCCGGAA-1	Neural_Posterior
TAGTAAGCAGCTCATA-1	Neural_Anterior
TAGTACGGTCAAACTG-1	Neural_Anterior
TAGTACGGTTAAGTGT-1	Neural_Anterior
TAGTACGGTTTAGTCC-1	Neural_Posterior
TAGTAGGAGACTTATG-1	Muscle
TAGTAGGAGAGAGGAG-1	Neural_Posterior
TAGTAGGAGTATTGTG-1	Neural_Posterior
TAGTCAATCCCTCAAC-1	Neural_Anterior
TAGTCAATCCGCAACA-1	Neural_Posterior
TAGTGAGAGCCATCAG-1	Neural_Anterior
TAGTGAGAGGCCTGGT-1	Neural_Anterior
TAGTGAGAGTTACCGG-1	Neural_Anterior
TAGTGGCGTAACTACG-1	Neural_Anterior
TAGTGGCGTACGGGTT-1	Neural_Anterior
TAGTGGCGTGTTAAAC-1	Neural_Anterior
TAGTTGTCACCGGTAT-1	Neural_Anterior
TAGTTGTCATGAGTTT-1	Neural_Posterior
TAGTTGTCATTAAAGG-1	Muscle
TAGTTTGAGCGCCTAA-1	Neural_Anterior
TAGTTTGAGTGTTGCG-1	Neural_Anterior
TATAACCCAAGCCACT-1	Neural_Posterior
TATAACCCACGTGCTG-1	NMPs
TATAACCCAGTTTGTG-1	Neural_Posterior
TATAGCCAGCTTAGCG-1	Neural_Anterior
TATAGCCAGGCAAGTA-1	Neural_Anterior
TATAGCCAGTAAAGGT-1	Neural_Posterior
TATAGCCAGTACTGGT-1	Neural_Posterior
TATAGCTCAGGCATGA-1	Neural_Posterior
TATAGGTGTCACTCGC-1	Neural_Anterior
TATAGGTGTTAGGATT-1	Neural_Anterior
TATAGGTGTTAGGTTG-1	Neural_Anterior
TATATCCTCATTTAGG-1	Neural_Posterior
TATATCCTCGTTCACC-1	Neural_Posterior
TATATCCTCTTACTCG-1	Neural_Anterior
TATCACAAGGTCCAAT-1	Neural_Posterior
TATCACAAGTGAACGA-1	Neural_Anterior
TATCCAGCAAGTGAAC-1	Neural_Anterior
TATCCAGCAGCACGTT-1	Neural_Anterior
TATCCAGCAGGAACCA-1	Somites
TATCGAGGTCTAACCT-1	Neural_Anterior
TATCGAGGTTCGCTTG-1	Neural_Anterior
TATCGCACAATAATCC-1	Neural_Anterior
TATCGCACAATGAGGT-1	Neural_Posterior
TATCGCGAGCTGAGGG-1	Neural_Anterior
TATGAAGCAACATAAG-1	Neural_Posterior
TATGAAGCAAGCTACC-1	Neural_Anterior
TATGAAGCACAGACTC-1	Neural_Posterior
TATGAAGCAGGCTTCG-1	Neural_Anterior
TATGACATCTAATCAG-1	Neural_Posterior
TATGACTCAATAGCAA-1	unassigned
TATGACTCAATGAATG-1	Neural_Posterior
TATGCATCAAGCGAGC-1	Neural_Posterior
TATGCATCAATATAGG-1	Neural_Posterior
TATGCATCACATTGCA-1	Neural_Posterior
TATGCATCAGTAGGAT-1	Neural_Anterior
TATGCATCAGTCTAGC-1	Neural_Anterior
TATGCATCATTGTGAT-1	Neural_Anterior
TATGGATGTGTCCAAA-1	Neural_Anterior
TATGGATGTGTGTCCC-1	Muscle
TATGGATGTGTTAGCA-1	Neural_Anterior
TATGGCCCACAATACT-1	Neural_Posterior
TATGGCCCACTTAACG-1	Neural_Posterior
TATGGCCCAGCTTACA-1	Neural_Posterior
TATGGGCGTGTTAGCA-1	Neural_Posterior
TATGGGCGTTAGTTGG-1	Neural_Anterior
TATGGTCAGCGCCTTT-1	Neural_Anterior
TATGGTCAGGCGTAAA-1	Neural_Anterior
TATGGTCAGTCCTGAG-1	Neural_Anterior
TATGTGATCGCACAAT-1	Neural_Anterior
TATGTGATCGTGCTAG-1	NMPs
TATTACCTCATGCATA-1	Neural_Anterior
TATTACCTCCCTCGCA-1	Neural_Posterior
TATTACCTCCCTGGTT-1	Neural_Posterior
TATTAGCCAGCAACAG-1	Neural_Posterior
TATTAGCCATACTCCT-1	Somites
TATTAGCCATATTGAC-1	Muscle
TATTAGCCATCAGCAC-1	Neural_Anterior
TATTAGGTCATGCTAA-1	Neural_Anterior
TATTAGGTCGATTTAG-1	Neural_Anterior
TATTCGTTCAATGTGC-1	Muscle
TATTCGTTCTAGCGAT-1	Neural_Posterior
TATTCGTTCTTAGCGG-1	Neural_Posterior
TATTGACCAAACCTTG-1	Neural_Anterior
TATTGACCAAATACCT-1	Neural_Posterior
TATTGACCAAGCCACT-1	Neural_Posterior
TATTGACCACAACAAA-1	Neural_Posterior
TATTGACCAGCCTTGG-1	Neural_Posterior
TATTTGCTCTAGCTTT-1	Neural_Posterior
TATTTGCTCTCGACCT-1	Neural_Anterior
TATTTGCTCTGCAAGT-1	unassigned
TATTTGCTCTGGCATG-1	Neural_Anterior
TATTTGGAGCTATGAC-1	Neural_Anterior
TATTTGGAGGACAACA-1	Neural_Anterior
TATTTGGAGGAGCAAC-1	Somites
TATTTGGAGGGCCACT-1	Neural_Posterior
TATTTGGAGTCAATTG-1	Neural_Anterior
TCAAACCAGCCGCAGT-1	Neural_Posterior
TCAAACCAGCGATAGA-1	Neural_Anterior
TCAAACCAGGTGAAGC-1	Neural_Posterior
TCAAACCAGTAGCGCC-1	Neural_Anterior
TCAAACCAGTATTGCA-1	Neural_Posterior
TCAAACCAGTTAGAGG-1	Neural_Posterior
TCAACAATCATGTGGT-1	Neural_Posterior
TCAACAATCCGTGACA-1	Neural_Anterior
TCAACAATCGATTTAG-1	Neural_Anterior
TCAACAATCGCTTCTA-1	Neural_Anterior
TCAACAATCGTTTCGC-1	Neural_Anterior
TCAAGAACAATCCCTT-1	Neural_Anterior
TCAAGCTAGCGCAATT-1	Neural_Anterior
TCAAGGAAGCCGGTAC-1	Neural_Posterior
TCAAGGAAGGCGGATG-1	Neural_Posterior
TCAAGGTTCGAGGAGT-1	Neural_Posterior
TCAAGGTTCTACTAAG-1	Neural_Posterior
TCAAGTATCATTTAGG-1	Neural_Anterior
TCAAGTATCCTAAATG-1	Neural_Anterior
TCAAGTATCCTGATGG-1	Neural_Anterior
TCAAGTATCTCGACCT-1	Neural_Anterior
TCAATCGCAACTAGCC-1	Neural_Anterior
TCAATCGCAGGATAAC-1	Neural_Anterior
TCAATCGCAGTCTATG-1	Neural_Posterior
TCACCGGCAAACTAAG-1	Neural_Anterior
TCACCGGCAAAGCTAA-1	Neural_Anterior
TCACCGGCAAGGTACG-1	Neural_Anterior
TCACCTCAGCAAGGTA-1	Neural_Anterior
TCACCTCAGCTCCTAC-1	Neural_Anterior
TCACCTGGTACCGTTT-1	Neural_Anterior
TCACCTGGTCTCAGCC-1	Neural_Anterior
TCACCTGGTGTTGCAA-1	Neural_Posterior
TCACCTGGTTTGGCTT-1	Neural_Posterior
TCACGGATCCTTAAGA-1	Neural_Posterior
TCACGGATCGCTAGTG-1	Neural_Anterior
TCACGGATCTTAGGAC-1	Neural_Anterior
TCACTGACAACGTGCT-1	Neural_Anterior
TCACTGACAATAATCC-1	Neural_Anterior
TCAGCAAGTCATTACC-1	Muscle
TCAGCAAGTTAGCTGA-1	Neural_Anterior
TCAGCCTTCAGGTTTA-1	Neural_Posterior
TCAGCCTTCATGTTTC-1	Neural_Anterior
TCAGCCTTCATTAGCA-1	Neural_Anterior
TCAGCCTTCCGGTTGA-1	Neural_Anterior
TCAGCCTTCTTAGCGG-1	Neural_Posterior
TCAGGAGCAACTAGAA-1	Neural_Posterior
TCAGGAGCACCAACCG-1	Neural_Posterior
TCAGGAGCAGCAAATA-1	Neural_Anterior
TCAGGAGCATATAACC-1	Neural_Anterior
TCAGGTCCAGCAAGTG-1	Neural_Anterior
TCAGGTCCATGTGGGA-1	Neural_Posterior
TCAGGTTAGTGATTCA-1	Neural_Posterior
TCAGTAATCCGCATGA-1	Neural_Posterior
TCAGTAATCCTTAGGG-1	Neural_Anterior
TCAGTAGGTACTGATG-1	Neural_Anterior
TCAGTAGGTAGCCATA-1	Neural_Anterior
TCAGTAGGTCCGTAGG-1	Neural_Posterior
TCAGTAGGTCGCAAAC-1	Neural_Posterior
TCAGTAGGTTGGATCA-1	Neural_Posterior
TCAGTGAGTGCATTTC-1	Neural_Anterior
TCAGTGAGTTCGCGCT-1	Neural_Posterior
TCATAACCAAATGCCC-1	Neural_Anterior
TCATAACCAACTGGCT-1	Neural_Anterior
TCATAACCACAGCCTG-1	Neural_Posterior
TCATAACCACGTGCTG-1	Neural_Posterior
TCATACTTCAATGACC-1	Neural_Anterior
TCATACTTCACTCAAA-1	Neural_Anterior
TCATACTTCATGCCTC-1	Neural_Posterior
TCATACTTCCACAATA-1	Neural_Posterior
TCATACTTCCAGGTCA-1	Neural_Posterior
TCATACTTCCGCCTCA-1	Neural_Anterior
TCATACTTCGTTACTT-1	Neural_Posterior
TCATCCATCCAGGAAA-1	Neural_Posterior
TCATCCATCTGTAAGC-1	Neural_Anterior
TCATGAGGTCGTAAAT-1	Neural_Anterior
TCATGCCTCGAAGTAG-1	Neural_Anterior
TCATGCCTCGGGACCT-1	Neural_Posterior
TCATGTTTCATAAGCC-1	Neural_Posterior
TCATGTTTCCAGGAAA-1	Neural_Posterior
TCATTACTCAAGACTC-1	Neural_Anterior
TCATTGCGTAATAGCT-1	Neural_Posterior
TCATTGCGTCTTTATG-1	Neural_Anterior
TCATTGTTCCTAAGAC-1	Neural_Posterior
TCATTGTTCGTGCTAG-1	Neural_Anterior
TCATTTGGTCAGGCCA-1	Neural_Anterior
TCATTTGGTGGATTCA-1	Somites
TCATTTGGTTTGCTGT-1	Neural_Anterior
TCCACAACATTGTGCA-1	Neural_Posterior
TCCAGCAAGAGAAGGG-1	Neural_Posterior
TCCAGCAAGTCATTGA-1	Somites
TCCAGCAAGTGTTGTA-1	Neural_Anterior
TCCAGGATCACAAGCT-1	Muscle
TCCAGGATCCATAATG-1	Neural_Anterior
TCCAGGATCCTAAGAC-1	Neural_Anterior
TCCAGGATCGCATCCT-1	Neural_Anterior
TCCAGGATCTTGGATA-1	Neural_Anterior
TCCAGGTCAAGGTATA-1	Neural_Anterior
TCCAGGTCAGTTGCGT-1	Neural_Posterior
TCCATAAAGATTCCTT-1	Neural_Posterior
TCCATAAAGCATGACT-1	Neural_Anterior
TCCATAAAGCATGGTT-1	Neural_Posterior
TCCATAAAGGGCTTTG-1	Neural_Posterior
TCCATAAAGTGAAGTG-1	unassigned
TCCATAAAGTGACCTG-1	Neural_Anterior
TCCATATTCATGTGGT-1	Neural_Anterior
TCCATATTCCCTGACT-1	Neural_Posterior
TCCATATTCCCTTGCG-1	Neural_Anterior
TCCATATTCGAGCAAA-1	Neural_Posterior
TCCATCATCAATAGCC-1	Neural_Anterior
TCCATCATCCTCATGC-1	Neural_Posterior
TCCATCATCCTTCGTA-1	Neural_Anterior
TCCATCATCGGTACGC-1	Somites
TCCATGCTCCCATAGG-1	Neural_Anterior
TCCATGCTCCCTCGCA-1	Neural_Posterior
TCCATGCTCCTTGTTG-1	Neural_Anterior
TCCATTGTCAAGCGCC-1	Neural_Anterior
TCCATTGTCACAAGCT-1	Neural_Posterior
TCCATTGTCACTTCAT-1	Neural_Anterior
TCCATTGTCCGGGACT-1	Neural_Posterior
TCCATTGTCTAAATCG-1	Neural_Posterior
TCCCGGACAGGAACCA-1	Neural_Posterior
TCCCGGACATTATGGT-1	Neural_Posterior
TCCCGTTAGCATTTCT-1	NMPs
TCCCGTTAGGCTGGCT-1	Muscle
TCCCTGGTCGAGGAAC-1	Neural_Posterior
TCCGCCATCTCCTCAA-1	Neural_Anterior
TCCGCCATCTTGCAAA-1	Neural_Anterior
TCCGGAATCAAAGGCA-1	Neural_Anterior
TCCGGTAAGGCTACTG-1	Neural_Posterior
TCCGGTTTCATTACGA-1	Neural_Anterior
TCCTAGTGTCCAAGAC-1	Neural_Anterior
TCCTAGTGTCCTAGTT-1	Neural_Anterior
TCCTCAATCGCTAGCA-1	Neural_Posterior
TCCTCACAGCTAATTG-1	Neural_Anterior
TCCTCTAAGATAACCC-1	Neural_Posterior
TCCTCTAAGCAAGGTA-1	Neural_Anterior
TCCTCTAAGGCTAGAA-1	Neural_Posterior
TCCTCTAAGTTTCCGC-1	Neural_Posterior
TCCTGTTCACTATGGC-1	Somites
TCCTGTTCATTAGCCA-1	Neural_Posterior
TCCTTAGTCATCCTAT-1	Neural_Anterior
TCCTTCAAGAACCTGT-1	Neural_Anterior
TCCTTCAAGCTCCTAC-1	Neural_Anterior
TCCTTCAAGGAAACTG-1	Neural_Anterior
TCCTTCAAGGAGCATA-1	Neural_Anterior
TCCTTCAAGGGCCATC-1	Neural_Anterior
TCCTTGCAGAACCTAC-1	unassigned
TCCTTGCAGAGAGGAG-1	Neural_Posterior
TCCTTGCAGCAAACCT-1	Neural_Anterior
TCCTTGCAGGAAGCTA-1	Neural_Posterior
TCCTTGCAGTGAGGGT-1	Neural_Anterior
TCCTTTACAATGAGGT-1	Neural_Anterior
TCCTTTACACATAGCC-1	Neural_Posterior
TCCTTTACAGGCATCT-1	Neural_Anterior
TCGACAAGTAGTTAAC-1	Neural_Posterior
TCGACAAGTATTGAGT-1	Neural_Anterior
TCGACAAGTCAAGTGC-1	Neural_Anterior
TCGACAAGTCCAAATG-1	Neural_Anterior
TCGATTAAGCCTCTGT-1	Neural_Anterior
TCGATTAAGGACGTAA-1	Neural_Posterior
TCGATTAAGTTATTCC-1	Somites
TCGCATTGTTAAATGC-1	Neural_Anterior
TCGCATTGTTAGACCA-1	Neural_Posterior
TCGCATTGTTGAGCCG-1	Somites
TCGCATTGTTTGGGTA-1	Neural_Anterior
TCGCCCATCCTCGATC-1	Neural_Posterior
TCGCCCATCGGTTAGT-1	Neural_Posterior
TCGCGAGGTTCATCTA-1	Neural_Anterior
TCGCGAGGTTTACCGT-1	Neural_Anterior
TCGCGCACACAAACTT-1	Neural_Posterior
TCGCGCACACGAACAG-1	Neural_Posterior
TCGCTAACAACACCTA-1	Neural_Anterior
TCGGTAAGTAGTCAAT-1	Neural_Posterior
TCGGTAAGTTATGTGG-1	Neural_Anterior
TCGGTAAGTTCCTGAT-1	Neural_Anterior
TCGGTTACAAGTGTTT-1	Neural_Anterior
TCGGTTACAGAAACGT-1	Neural_Posterior
TCGGTTCTCAATCATG-1	Neural_Anterior
TCGGTTCTCACAGGAA-1	Neural_Anterior
TCGGTTCTCCACCTGT-1	Neural_Anterior
TCGGTTCTCCCTCAAC-1	Neural_Posterior
TCGGTTCTCCTCATCA-1	Neural_Anterior
TCGGTTTGTGCTCACC-1	Neural_Anterior
TCGGTTTGTGTCCTGC-1	Neural_Anterior
TCGGTTTGTTGCCTCA-1	Neural_Anterior
TCGGTTTGTTTAGCGA-1	Neural_Posterior
TCGTAATCAAGTAAGC-1	Neural_Anterior
TCGTCAACACTGGCCA-1	Neural_Anterior
TCGTTAAAGCAAGACA-1	Neural_Posterior
TCGTTAAAGGAACCGG-1	Neural_Anterior
TCGTTAAAGGTTTGAC-1	Neural_Anterior
TCGTTACGTTTGGGCG-1	Neural_Posterior
TCGTTAGCAGTAGCCT-1	Neural_Posterior
TCGTTATTCATAAGCC-1	Neural_Anterior
TCGTTATTCGTCATTT-1	Neural_Posterior
TCGTTATTCTCACTAT-1	Neural_Posterior
TCGTTTCCAAAGCTAA-1	Neural_Anterior
TCGTTTCCAACTAGCC-1	Neural_Anterior
TCGTTTCCAAGCGATG-1	Neural_Anterior
TCGTTTCCAGCTACGT-1	Neural_Anterior
TCGTTTCCATAGCTGC-1	Neural_Posterior
TCTAACCGTACAATGT-1	Neural_Anterior
TCTAACCGTGAAACAA-1	Neural_Anterior
TCTAACCGTGCTCCAC-1	Neural_Anterior
TCTAACCGTGCTGTAA-1	Neural_Posterior
TCTAACCGTTATGTGG-1	Neural_Anterior
TCTAACTTCCTAATAG-1	Neural_Anterior
TCTAAGGGTCATGCCC-1	Neural_Posterior
TCTAAGGGTCCCGAAG-1	Neural_Posterior
TCTAAGGGTTGACTTC-1	Neural_Posterior
TCTAATCTCAACCAAC-1	Neural_Anterior
TCTAATCTCTACCTCA-1	Neural_Anterior
TCTAATCTCTTGCATT-1	Neural_Anterior
TCTACCTCAGTAGGTG-1	Neural_Posterior
TCTACCTCATTCCTGT-1	Neural_Anterior
TCTACTAGTACTGATG-1	Neural_Posterior
TCTACTAGTCGACTAA-1	Neural_Anterior
TCTACTAGTGATGAAA-1	Neural_Anterior
TCTACTAGTTCACCAT-1	Neural_Anterior
TCTAGCACAAAGCGGC-1	Somites
TCTAGCACAGTAGCCT-1	Neural_Anterior
TCTAGCCTCCAGGGAG-1	Neural_Anterior
TCTAGCCTCCCTTGCG-1	Neural_Posterior
TCTAGCCTCTCCATAT-1	Somites
TCTATGTTCTTGCTAT-1	Neural_Posterior
TCTCAAGCAATTATGC-1	Neural_Anterior
TCTCAAGCATCCCTCA-1	Neural_Anterior
TCTCAATTCAAGTGTC-1	Neural_Anterior
TCTCAATTCTAAATCG-1	Neural_Anterior
TCTCACCAGCCGCAAC-1	Neural_Anterior
TCTCACCAGCCTGGTA-1	Neural_Posterior
TCTCACCAGGAGGTTA-1	Neural_Anterior
TCTCACCAGTTAGTTG-1	Neural_Anterior
TCTCCTCGTGGATTGC-1	Neural_Posterior
TCTCGCCCACCGGCTA-1	Neural_Anterior
TCTCGCCCAGCTCATA-1	Neural_Anterior
TCTCGCCCATTGTGGC-1	Neural_Posterior
TCTGGCTTCGCAACAT-1	Neural_Anterior
TCTGGCTTCGCATCCT-1	Neural_Posterior
TCTGGCTTCTAATCTC-1	Neural_Anterior
TCTGTGACAATAATCC-1	Neural_Posterior
TCTGTGACAGCAAATA-1	Neural_Posterior
TCTGTGACAGCCTTGG-1	Somites
TCTGTGACAGGCGAGT-1	Somites
TCTGTGACATGAGTTT-1	Neural_Posterior
TCTGTGACATTAAAGG-1	Neural_Anterior
TCTTAGCGTCCTTCAG-1	Neural_Posterior
TCTTAGCGTGTTTCAC-1	Neural_Posterior
TCTTAGCGTTTGAGGC-1	NMPs
TCTTAGTTCGTAACGT-1	Neural_Anterior
TCTTAGTTCTGTGAGT-1	Neural_Posterior
TCTTGACGTGTTTGTC-1	Neural_Anterior
TCTTGACGTTCGGGAT-1	Neural_Anterior
TCTTGTCCATAGCAGG-1	Neural_Anterior
TCTTGTCCATGGCCCA-1	Neural_Posterior
TCTTTGTAGAAAGCAT-1	Neural_Anterior
TCTTTGTAGCTTATGA-1	Neural_Anterior
TGAAACTGTAGTTACG-1	Neural_Posterior
TGAAACTGTATTTGCC-1	Neural_Anterior
TGAAACTGTCATCAAG-1	Neural_Anterior
TGAAACTGTGCTTTAC-1	Neural_Anterior
TGAACAACAAACGCGA-1	Neural_Anterior
TGAACAACAAACTGCC-1	Neural_Anterior
TGAACAGAGATACTTG-1	Somites
TGAACAGAGCTACTGG-1	Neural_Anterior
TGAACAGAGCTTGCTC-1	Neural_Anterior
TGAACAGAGGCCAATT-1	Somites
TGAAGCAAGCATTTCT-1	Neural_Posterior
TGAAGCAAGCCTAATA-1	Neural_Posterior
TGAAGCAAGTCACCTC-1	Neural_Anterior
TGAAGGATCAAACTCA-1	Neural_Anterior
TGAAGGATCCTGGTGA-1	Somites
TGAAGTGAGGCGCTAC-1	Neural_Anterior
TGACCAAGTCTAGCTT-1	Neural_Posterior
TGACCAAGTTCAAGAT-1	Neural_Posterior
TGACCTTGTACGTTTC-1	Neural_Posterior
TGACCTTGTCAATGTG-1	Neural_Anterior
TGACTCCTCATTGCAA-1	Neural_Posterior
TGACTCCTCTAAGGTC-1	Neural_Posterior
TGACTTAAGGCCCAGT-1	Neural_Anterior
TGACTTAAGTCAATCA-1	Neural_Anterior
TGACTTCGTCGAAGTC-1	Neural_Posterior
TGACTTCGTCTAACAG-1	Neural_Posterior
TGACTTCGTGGACCTG-1	Neural_Anterior
TGACTTCGTGGATTCA-1	Neural_Anterior
TGAGAACCAATAGTCT-1	Neural_Anterior
TGAGAACCAGTAGCCT-1	Neural_Anterior
TGAGAACCATAATGTC-1	Neural_Posterior
TGAGCAAAGACTATTG-1	Neural_Posterior
TGAGCAAAGCTCCCTG-1	Neural_Anterior
TGAGCAAAGGCGCACT-1	Neural_Anterior
TGAGCACGTTACATCC-1	Neural_Anterior
TGAGCCGGTCACGGAT-1	Neural_Posterior
TGAGCCGGTTTGAGGC-1	Neural_Posterior
TGAGCTTAGCTGAGGG-1	Neural_Anterior
TGAGCTTAGGAGGACT-1	Neural_Anterior
TGAGGAGGTCCGCTGT-1	Neural_Anterior
TGAGGAGGTGGATGTC-1	Neural_Anterior
TGAGGAGGTTAAGCGC-1	Neural_Posterior
TGAGGAGGTTAGTGAT-1	Neural_Anterior
TGAGGCACAAACGCGA-1	Neural_Posterior
TGAGGCACAAAGCCTC-1	Neural_Anterior
TGAGGCACACTGGCTG-1	Neural_Anterior
TGAGGCACAGCCTGCA-1	Neural_Posterior
TGAGGCACATGAAATG-1	Neural_Posterior
TGAGGGAGTAACAGGG-1	Somites
TGAGGGAGTTAAGTGT-1	Neural_Anterior
TGAGGGAGTTGCATCT-1	Neural_Posterior
TGAGGTGCAGCTTAGC-1	Neural_Posterior
TGAGTGAAGGGACCTC-1	Neural_Posterior
TGAGTTTCATAATCGT-1	Neural_Posterior
TGATCAATCAATTACG-1	Neural_Anterior
TGATCAATCATAACTG-1	Neural_Anterior
TGATCAATCATGAAGG-1	Neural_Posterior
TGATCAATCCCTCATA-1	Neural_Anterior
TGATCAATCCCTGTTA-1	Neural_Posterior
TGATCAATCCTAGTCC-1	Neural_Anterior
TGATCACAGCAACATC-1	Neural_Posterior
TGATCACAGTGAGGGT-1	Neural_Posterior
TGATCAGGTCCTAACT-1	Neural_Anterior
TGATCAGGTTAAGTGT-1	Neural_Posterior
TGATCGAGTTATCGAG-1	Neural_Anterior
TGATCGAGTTCCTGAT-1	Neural_Anterior
TGATGAACAGGCTTCG-1	Neural_Anterior
TGATGAACAGGTTCAC-1	Neural_Posterior
TGATGACTCAATGTCA-1	Neural_Anterior
TGATGACTCACACAGT-1	Neural_Posterior
TGATGATGTATTACCC-1	Neural_Posterior
TGATGATGTTGTTGTC-1	Neural_Anterior
TGATTAGTCACAGCGC-1	Neural_Posterior
TGATTAGTCATTGCAA-1	Neural_Anterior
TGATTCAAGGGTGGAT-1	Neural_Anterior
TGATTCAAGTATTGTG-1	Neural_Anterior
TGATTGCAGGGTTAGA-1	Neural_Posterior
TGATTGCAGTGCACGC-1	Somites
TGCAAGCGTCCTTCAG-1	Neural_Posterior
TGCAATATCATGGTGT-1	Neural_Posterior
TGCAATATCTTGTCTG-1	Neural_Anterior
TGCACACCACTAAGCC-1	Neural_Anterior
TGCACACCACTTAGGC-1	Neural_Anterior
TGCACACCATAAGGAC-1	Muscle
TGCACACCATAGACCC-1	Neural_Anterior
TGCACACCATCACTTC-1	NMPs
TGCACCTTCATCCTCA-1	Neural_Posterior
TGCACCTTCGTAACGT-1	Neural_Posterior
TGCACCTTCTTGATGA-1	Neural_Anterior
TGCACTTGTATTACCC-1	Muscle
TGCACTTGTCCTTAGT-1	Muscle
TGCACTTGTCTTTATG-1	Neural_Posterior
TGCACTTGTGATGAAA-1	Neural_Anterior
TGCAGGCTCCACCTTA-1	Somites
TGCATCCTCCCAGTAG-1	Neural_Posterior
TGCATCCTCGATTATG-1	Neural_Anterior
TGCATGAGTACCCACC-1	Neural_Anterior
TGCATGAGTAGTTACG-1	Neural_Anterior
TGCATGAGTTAACACG-1	Neural_Posterior
TGCATTAAGAGAGGCT-1	Neural_Posterior
TGCATTAAGCTTAGTA-1	Neural_Posterior
TGCATTAAGTAATCCA-1	Neural_Posterior
TGCATTAAGTTGTCCC-1	Neural_Anterior
TGCCATTGTAGCAGCT-1	Somites
TGCCATTGTGATTTGG-1	Neural_Anterior
TGCCGGTAGGGACTAA-1	Neural_Posterior
TGCCTGTTCCCGTTGT-1	Neural_Posterior
TGCCTGTTCGGGACCT-1	Neural_Posterior
TGCGCAGGTACTTAGG-1	Neural_Anterior
TGCGCAGGTCATTACC-1	Neural_Anterior
TGCGCAGGTGTTGCTT-1	Neural_Posterior
TGCGCGAGTTCACTGT-1	Somites
TGCGCGAGTTTCAGGA-1	Neural_Posterior
TGCGGTTCAACTCGCG-1	Neural_Anterior
TGCGGTTCACCTCGCT-1	Neural_Posterior
TGCGGTTCAGGCGATA-1	Neural_Posterior
TGCGGTTCAGGTTATT-1	Neural_Anterior
TGCGGTTCATAGTCAT-1	Muscle
TGCGGTTCATCGCTCC-1	Neural_Anterior
TGCTAGCCAATTGACT-1	Neural_Posterior
TGCTATGCACAAGCCT-1	Neural_Posterior
TGCTATGCACGTTACA-1	Neural_Anterior
TGCTCAACAAGGTCCT-1	Neural_Posterior
TGCTCACTCATCACTT-1	Neural_Anterior
TGCTCACTCCCTCAGT-1	Somites
TGCTCACTCTCAATGA-1	Neural_Posterior
TGCTCCGTCATAGCCG-1	Neural_Anterior
TGCTCCGTCCCTGGAA-1	Neural_Anterior
TGCTCCGTCCCTTGCG-1	Neural_Anterior
TGCTCCGTCGCTCACT-1	Neural_Anterior
TGCTCCGTCTAGCTTT-1	Neural_Posterior
TGCTCCGTCTCCTCTT-1	Neural_Anterior
TGCTGGATCAAAGGCA-1	Neural_Anterior
TGCTGGATCAATCTAG-1	Neural_Anterior
TGCTGGATCTGTGCCT-1	Neural_Posterior
TGCTTAAAGGTCCTGA-1	Neural_Posterior
TGCTTAAAGTTAGCCG-1	Somites
TGCTTAAAGTTGGCCA-1	Neural_Anterior
TGCTTCCAGATAACCC-1	Neural_Anterior
TGCTTCCAGCCTGACA-1	Neural_Anterior
TGCTTCCAGGCTGTCA-1	Neural_Posterior
TGCTTCCAGGTCGATT-1	Neural_Anterior
TGCTTGCTCTAATCTC-1	Neural_Anterior
TGCTTTAGTCGACTAA-1	Neural_Posterior
TGCTTTAGTCTCAGCC-1	Neural_Anterior
TGCTTTAGTGCACGCA-1	Neural_Posterior
TGCTTTAGTTCGCGCT-1	Muscle
TGGACAAAGCTCCTTA-1	Neural_Anterior
TGGACCGGTCATAACG-1	Neural_Posterior
TGGACCGGTTGGTTAG-1	Neural_Anterior
TGGACCGGTTTGGGTA-1	Somites
TGGACTAGTGGGTACT-1	Neural_Anterior
TGGACTAGTTCCGCAC-1	Neural_Anterior
TGGACTAGTTGCAGTA-1	Neural_Posterior
TGGACTAGTTTATCGC-1	Neural_Anterior
TGGATTCAGGCTAAGA-1	Neural_Anterior
TGGATTCAGTCAGTAC-1	Neural_Anterior
TGGATTGGTGTCACGG-1	Neural_Anterior
TGGATTGGTTAACGAT-1	Neural_Anterior
TGGATTGGTTGGTTAG-1	Neural_Anterior
TGGCCAATCATTCATC-1	Neural_Anterior
TGGCCAATCGCGACAC-1	Neural_Anterior
TGGCCAATCGCTTGCT-1	Neural_Posterior
TGGCCATCACCCTCAC-1	Neural_Anterior
TGGCCATCACGAATCC-1	Neural_Posterior
TGGCCATCAGAGAGCC-1	Neural_Anterior
TGGCCATCATTGCGAC-1	Neural_Anterior
TGGCCTGCAAACCCTA-1	Neural_Anterior
TGGCCTGCAAGGTCCT-1	Neural_Anterior
TGGCCTGCATTATGGT-1	Neural_Anterior
TGGCCTTTCCGCCTAT-1	Neural_Anterior
TGGCCTTTCGAAGCGG-1	Neural_Anterior
TGGCCTTTCGTTAACA-1	Neural_Posterior
TGGCCTTTCTAACTGA-1	Neural_Anterior
TGGCCTTTCTATGACA-1	Neural_Posterior
TGGCGGTTCATTAGGC-1	Neural_Posterior
TGGCGGTTCCCAGTAG-1	Neural_Anterior
TGGCTAAGTAGGATCC-1	Neural_Anterior
TGGCTAAGTTTCGCCA-1	Neural_Posterior
TGGCTATAGGAAGCAC-1	Neural_Posterior
TGGCTATAGTATTGCA-1	Neural_Anterior
TGGCTTTGTTAACACG-1	Neural_Posterior
TGGCTTTGTTAGTACG-1	Neural_Anterior
TGGGCATGTAACAGGG-1	Neural_Anterior
TGGGCATGTATCTGGA-1	Neural_Anterior
TGGGCATGTGCGCATG-1	Neural_Anterior
TGGGCATGTGGAAGGC-1	Neural_Anterior
TGGGCCTAGAAGCTAG-1	Neural_Posterior
TGGGCCTAGTAACCAC-1	Neural_Anterior
TGGTAAACAAATGCCC-1	Neural_Anterior
TGGTAAACAAGTGAAC-1	Neural_Anterior
TGGTAAACAATGCGCT-1	Neural_Anterior
TGGTCAAGTCCCGAAG-1	Neural_Posterior
TGGTCAAGTCGTTACT-1	Neural_Posterior
TGGTCAAGTTACCGGG-1	Neural_Anterior
TGGTCAAGTTAGGCGT-1	Neural_Posterior
TGGTCAAGTTTGCGCC-1	Neural_Posterior
TGGTCAGTCAGGAAGC-1	Neural_Anterior
TGGTCAGTCATTAGCA-1	Neural_Posterior
TGGTCAGTCCGCTAGA-1	Neural_Posterior
TGGTCATAGACAGGTA-1	Neural_Anterior
TGGTCATAGGACGTAA-1	Neural_Anterior
TGGTCCTTCAGCCAAT-1	Neural_Posterior
TGGTCCTTCCAATTAG-1	Neural_Posterior
TGGTCCTTCCCTGACT-1	Neural_Anterior
TGGTCCTTCGATATTG-1	Neural_Posterior
TGGTCCTTCGCAAACT-1	Neural_Posterior
TGGTGATTCACATTGA-1	Neural_Anterior
TGGTGATTCCGCACAA-1	Neural_Posterior
TGGTGATTCGAGCAAA-1	Neural_Anterior
TGGTGATTCGGCCATA-1	Neural_Anterior
TGGTGATTCGTCCTTA-1	Neural_Anterior
TGGTGATTCTCCTCAA-1	Neural_Anterior
TGGTGATTCTTTGACT-1	Neural_Anterior
TGGTGCATCACAAGCT-1	Neural_Anterior
TGGTGCATCGTTAACA-1	Neural_Anterior
TGGTGCATCTAAGGTC-1	Neural_Anterior
TGGTTAATCCCTGTTA-1	Neural_Posterior
TGGTTAATCGAAGTGA-1	Neural_Anterior
TGGTTAATCTAACCAA-1	Neural_Anterior
TGGTTCCTCCCGCCTA-1	Neural_Anterior
TGGTTCCTCGGGACTC-1	Neural_Posterior
TGGTTCTGTACGTTTC-1	Neural_Posterior
TGGTTCTGTCCTTCAG-1	Neural_Anterior
TGGTTCTGTCGTTACT-1	Neural_Posterior
TGGTTCTGTCTTGCTG-1	Neural_Posterior
TGGTTGAGTCTTTGAC-1	Neural_Anterior
TGGTTGAGTGTCACGG-1	Neural_Posterior
TGGTTGAGTGTTCCCA-1	Neural_Posterior
TGGTTGAGTTCGGGAT-1	Neural_Anterior
TGTAAAGCATAATCGT-1	Neural_Anterior
TGTAAAGCATAGCGAG-1	Neural_Posterior
TGTAACTCAATAGCCC-1	Muscle
TGTAACTCAATAGTCT-1	Neural_Posterior
TGTAACTCAGGCATCT-1	Neural_Anterior
TGTAACTCATTAGCGC-1	Neural_Anterior
TGTAAGCTCACCGGTA-1	Neural_Posterior
TGTAAGCTCATAGCCG-1	Neural_Anterior
TGTAAGCTCGATTTGA-1	Neural_Anterior
TGTAAGCTCGGTTACG-1	Neural_Posterior
TGTAAGTGTGATTTGG-1	Neural_Anterior
TGTAAGTGTTTGAGGC-1	Neural_Posterior
TGTAATGTCCTAATTC-1	Neural_Posterior
TGTAATGTCTTTGAGA-1	Neural_Anterior
TGTATCCGTATTGGTG-1	Neural_Posterior
TGTATCCGTCCTTTAA-1	Neural_Anterior
TGTATCGCAGCGCTTG-1	Neural_Anterior
TGTATCGCAGGATGGC-1	Neural_Posterior
TGTATCGCATCCCGCT-1	Neural_Anterior
TGTCAATCAACTAACT-1	Somites
TGTCAATCAATGAGGT-1	Neural_Anterior
TGTCAATCACAGAACG-1	Neural_Anterior
TGTCAATCACATTAAC-1	Neural_Posterior
TGTCAATCAGAAACGT-1	Neural_Posterior
TGTCAATCAGCAATAA-1	Neural_Posterior
TGTCAATCATCTTGAG-1	Neural_Anterior
TGTCAGTAGCGAGTAA-1	Neural_Posterior
TGTCAGTAGCTTTGTT-1	Neural_Anterior
TGTCAGTAGTTTCCTG-1	Neural_Anterior
TGTCATAAGAGCCGGA-1	Neural_Anterior
TGTCATAAGCAAGACA-1	Neural_Anterior
TGTCATAAGTTGGATC-1	Neural_Posterior
TGTCCTGGTGACATGC-1	Neural_Anterior
TGTCCTGGTGTTGCTT-1	Neural_Anterior
TGTCCTGGTGTTGTGA-1	Neural_Anterior
TGTCCTGGTTAAGCGC-1	Neural_Anterior
TGTCCTTCAAATTGCT-1	Neural_Posterior
TGTGCAAGTGTCCTGC-1	Neural_Anterior
TGTGCAAGTGTTTGTC-1	Neural_Posterior
TGTGCAAGTTTGGGCG-1	Neural_Anterior
TGTGCACCAGTAGGAT-1	Neural_Posterior
TGTGCACCATTCAGCA-1	Neural_Posterior
TGTGCGCAGATAAAGC-1	Neural_Posterior
TGTGCGCAGCGGCTGT-1	Neural_Anterior
TGTGCGCAGCTGGACC-1	Neural_Anterior
TGTGCGCAGCTGTACG-1	Neural_Anterior
TGTGCGGGTCAGGCAT-1	Neural_Anterior
TGTGCGGGTGAACAAA-1	Neural_Posterior
TGTGCGGGTTACAAAC-1	Somites
TGTGCTGAGCACAGCC-1	Neural_Posterior
TGTGCTGAGCACGATT-1	Neural_Posterior
TGTGCTGAGCCTGACA-1	Neural_Anterior
TGTGCTGAGTGAGCGG-1	Neural_Anterior
TGTGGAGCAACTAGGG-1	Neural_Anterior
TGTGGAGCACGGTTTA-1	Neural_Posterior
TGTGGAGCATGTCAGC-1	Neural_Posterior
TGTGGCCAGCCTGAGC-1	Neural_Anterior
TGTGGCGGTTAACGAT-1	Neural_Anterior
TGTGGCTCAAGTGAAC-1	Neural_Posterior
TGTGGCTCAATACTGT-1	Neural_Anterior
TGTGGCTCAATGCGCT-1	Neural_Posterior
TGTGGCTCACAACAAA-1	Neural_Posterior
TGTGGCTCAGGGAGGA-1	Muscle
TGTGGCTCAGTAGGTG-1	Neural_Anterior
TGTGGCTCATGAAGTA-1	Neural_Posterior
TGTGTGAGTAAGCTTG-1	Neural_Posterior
TGTGTGAGTCCTTAGT-1	Neural_Posterior
TGTGTGAGTTCCAGGG-1	Neural_Posterior
TGTGTGAGTTTGAGCA-1	Neural_Posterior
TGTGTTAAGCCATCAG-1	Neural_Anterior
TGTGTTAAGCTATATG-1	Somites
TGTGTTAAGGATAAAC-1	Neural_Posterior
TGTGTTAAGGCGGGTA-1	Neural_Posterior
TGTTACTTCCGGTTGA-1	Neural_Posterior
TGTTACTTCTTACTCG-1	Neural_Posterior
TGTTAGCAGAATCTCA-1	Neural_Anterior
TGTTAGCAGGCACAGG-1	Neural_Anterior
TGTTAGCAGGGATGCG-1	Neural_Anterior
TGTTATGAGCACGTTG-1	Neural_Posterior
TGTTATGAGTTATCTC-1	Neural_Anterior
TGTTCATTCACAGACT-1	Neural_Posterior
TGTTCATTCATTAGCA-1	Neural_Anterior
TGTTCATTCCCTCATA-1	Neural_Posterior
TGTTCCTCACTTACAG-1	Neural_Anterior
TGTTCCTCAGGTTACC-1	Neural_Posterior
TGTTCCTCATGCATAT-1	Neural_Anterior
TGTTGCACAACAACAA-1	Neural_Anterior
TGTTGCACAACCTGGT-1	Neural_Anterior
TGTTGCACACAAGCCT-1	Neural_Anterior
TGTTGCACACCTAAGC-1	Neural_Anterior
TGTTGCACACCTAATG-1	Neural_Posterior
TGTTGCACATGTTTGG-1	Neural_Anterior
TGTTGGCCACTGGCCA-1	Neural_Anterior
TGTTGGCCATACTCCT-1	Neural_Anterior
TGTTGGCCATCAATCG-1	Neural_Anterior
TGTTGGCCATCTTGAG-1	Neural_Anterior
TGTTGGCCATTTAAGC-1	Neural_Anterior
TGTTGTAAGAGGGACT-1	Neural_Posterior
TGTTGTGCACAAACTT-1	Somites
TGTTGTGCAGAAATTG-1	Muscle
TGTTGTGCATAGTCAT-1	Neural_Anterior
TGTTGTTTCACAAGCT-1	Neural_Posterior
TGTTGTTTCACTTCAT-1	Neural_Posterior
TGTTGTTTCCACCTGT-1	Neural_Anterior
TGTTTGTTCGCCTAAG-1	Neural_Posterior
TTAAAGGCAGCAAGTG-1	Neural_Posterior
TTAAAGGCAGGGAGGA-1	Neural_Anterior
TTAACCAAGCAGGTTT-1	Neural_Anterior
TTAACCAAGCGAAGTA-1	Neural_Anterior
TTAACCAAGCTCATAA-1	Neural_Anterior
TTAACCAAGTCAATTG-1	Neural_Anterior
TTAACCAAGTGGCGGA-1	Neural_Posterior
TTAACTGAGCAGCTCA-1	Neural_Posterior
TTAACTGAGCATGACT-1	Neural_Posterior
TTAACTGAGGTCCTGA-1	Neural_Anterior
TTAAGCCAGCTGCACA-1	Neural_Anterior
TTAAGGACAAACGCGA-1	Neural_Anterior
TTAAGGACACAATTAC-1	Neural_Anterior
TTAAGGACATACCCGG-1	Neural_Posterior
TTAAGGACATTGACAT-1	Neural_Posterior
TTAAGGACATTGTGTG-1	Neural_Anterior
TTAAGGTGTATTGTCC-1	Neural_Anterior
TTAAGGTGTTGCTGGG-1	Neural_Posterior
TTAAGGTGTTTGCAGA-1	Neural_Anterior
TTAAGTGTCCACCCTG-1	Neural_Anterior
TTAAGTGTCCTGAGTG-1	Neural_Anterior
TTAATCGAGGGCTAAA-1	Neural_Posterior
TTACACCGTAACTACG-1	Neural_Anterior
TTACACCGTGCTGGTG-1	Muscle
TTACACCGTTCGGGAT-1	Neural_Anterior
TTACAGCAGCATGCAT-1	Neural_Posterior
TTACAGCAGTGAGAGC-1	Neural_Posterior
TTACAGCAGTGGCGGA-1	Neural_Anterior
TTACCGTGTAAGCTCA-1	Neural_Posterior
TTACCGTGTATTCGTC-1	Neural_Anterior
TTACCTGTCAGCATTA-1	Muscle
TTACCTGTCCCTCTAA-1	Neural_Anterior
TTACGTTTCGCTATGG-1	Neural_Anterior
TTAGAAGCAAACCTAT-1	Neural_Anterior
TTAGAAGCAAACTCAT-1	Neural_Posterior
TTAGAAGCAGAATGAC-1	Neural_Anterior
TTAGAAGCAGGACCTT-1	Neural_Anterior
TTAGACTCAATATGGA-1	Neural_Posterior
TTAGACTCACCTGTAA-1	Neural_Anterior
TTAGACTCACTAAATC-1	Neural_Anterior
TTAGACTCAGAGAGCC-1	unassigned
TTAGCAATCTCGCCTG-1	Neural_Anterior
TTAGCAGGTAATGACT-1	Neural_Anterior
TTAGCAGGTCATTAGG-1	Neural_Anterior
TTAGCCTGTGTGAGAG-1	Neural_Posterior
TTAGCCTGTTTAACCC-1	Neural_Posterior
TTAGCCTGTTTAGTCC-1	Neural_Anterior
TTAGCGGTCGATTTAG-1	Neural_Posterior
TTAGCGGTCGTGCCTT-1	Neural_Anterior
TTAGCTGCACCGGTAT-1	Neural_Anterior
TTAGCTGCACGTTACA-1	Neural_Anterior
TTAGCTGCAGGAACCA-1	Muscle
TTAGCTGCATAGTCAT-1	Muscle
TTAGGATGTTACAAAC-1	Neural_Posterior
TTAGGCCCACCAGCAT-1	Neural_Posterior
TTAGGCCCAGGACCAA-1	Somites
TTAGGCCCATAGCTGC-1	Neural_Posterior
TTAGGCGTCGGTACGC-1	Neural_Anterior
TTAGGCTAGCAAGGAC-1	Neural_Anterior
TTAGGCTAGTCACTCC-1	Neural_Posterior
TTAGTCAAGCTCGCTT-1	Neural_Posterior
TTAGTCAAGGCAAGTA-1	Neural_Anterior
TTAGTCAAGGTCGAGG-1	Neural_Posterior
TTAGTCAAGTATTGCA-1	Neural_Posterior
TTAGTCAAGTGAACAG-1	Neural_Posterior
TTATAGCCAAACAACA-1	Neural_Anterior
TTATAGCCAATAACGA-1	Neural_Anterior
TTATAGCCAGGTATTT-1	Neural_Anterior
TTATAGCCATCAGTAT-1	Neural_Anterior
TTATAGCCATTAGGCC-1	Neural_Anterior
TTATCCGTCCATTACT-1	Neural_Posterior
TTATCCGTCGCGCTAA-1	Neural_Anterior
TTATCCGTCGTGCCTT-1	Neural_Anterior
TTATCCGTCTGTGAGT-1	Neural_Anterior
TTATCCTAGACACCGC-1	Neural_Anterior
TTATCCTAGATTGAGG-1	Neural_Anterior
TTATCCTAGCGAAGTA-1	Neural_Anterior
TTATCCTAGCTGTACG-1	Neural_Posterior
TTATCCTAGTTGCCTC-1	Neural_Anterior
TTATGACCAGTCTATG-1	Neural_Posterior
TTATGACCATGAGCAG-1	Neural_Posterior
TTATGCGCAATTGAGA-1	Neural_Posterior
TTATGCGCACCTAAGC-1	Neural_Posterior
TTATGCGCATTGCGAC-1	Neural_Anterior
TTATTGCTCTACCTAT-1	Neural_Anterior
TTCAACCGTAACTACG-1	Neural_Anterior
TTCAACCGTCTAACAG-1	Neural_Anterior
TTCACTGTCACCTGCT-1	Somites
TTCACTGTCCCGTTTA-1	NMPs
TTCAGGTAGCCTGTGA-1	Neural_Anterior
TTCAGGTAGTTATCCT-1	Neural_Anterior
TTCAGTTTCATCCACC-1	Neural_Anterior
TTCATCCCAGCTTACA-1	Neural_Posterior
TTCATTCAGCAAGGTA-1	Somites
TTCATTCAGGACACTT-1	Neural_Posterior
TTCATTCAGGTTACAC-1	Neural_Posterior
TTCATTCAGTCTGGGC-1	unassigned
TTCCACGGTCAGGCCA-1	Neural_Posterior
TTCCCACAGAACAAGT-1	Neural_Posterior
TTCCCACAGGCACAGG-1	Neural_Posterior
TTCCCGCCAAGTAAGC-1	Neural_Anterior
TTCCCGCCAATAATGG-1	Neural_Posterior
TTCCTCAAGACTATTG-1	Neural_Anterior
TTCCTCAAGCTAAGTC-1	Neural_Anterior
TTCCTCAAGGTGTTAC-1	Neural_Anterior
TTCCTCAAGTATGTGC-1	Neural_Anterior
TTCCTCAAGTTAGCTA-1	Neural_Posterior
TTCCTCAAGTTGTCTT-1	Neural_Posterior
TTCCTTCTCACTTTAC-1	Neural_Anterior
TTCCTTCTCCCGTTAC-1	Somites
TTCCTTCTCGAGGAAC-1	Neural_Posterior
TTCCTTCTCGTTACAA-1	Neural_Anterior
TTCCTTGAGGAAGCTA-1	Neural_Posterior
TTCCTTGAGTCACGAT-1	Neural_Anterior
TTCGCAACAGCACCAT-1	Somites
TTCGCAACAGGATAAC-1	Neural_Posterior
TTCGGTACAAGCCAGA-1	Neural_Posterior
TTCGGTACAAGCTTAT-1	Neural_Posterior
TTCGTGCTCATCCTAT-1	Neural_Posterior
TTCGTGCTCATGCGTG-1	Somites
TTCGTGCTCTCGCCCA-1	Neural_Anterior
TTCGTTAGTATTGTGG-1	Neural_Anterior
TTCGTTAGTGGAGCAA-1	Neural_Anterior
TTCGTTAGTGGATTAT-1	Neural_Anterior
TTCTTAGGTGCATCGG-1	Neural_Posterior
TTCTTAGGTTGGCCGA-1	Neural_Anterior
TTGACATCACAGGATG-1	Neural_Posterior
TTGACATCATCGCTCC-1	Neural_Anterior
TTGACATCATCGCTTT-1	Neural_Anterior
TTGACATCATTAGGTT-1	Neural_Anterior
TTGACGTAGAAAGCAT-1	Neural_Posterior
TTGACGTAGGCGGGTA-1	Muscle
TTGACTAAGCCGCAGT-1	Neural_Anterior
TTGACTAAGCCTAACG-1	Neural_Anterior
TTGACTAAGGATTGCT-1	Neural_Posterior
TTGACTAAGTCTTGAA-1	Somites
TTGAGCTAGGACGTAA-1	Neural_Posterior
TTGAGCTAGGCGCATC-1	Neural_Posterior
TTGAGCTAGGGTCCAC-1	Neural_Posterior
TTGAGCTAGTAAGAAC-1	Neural_Posterior
TTGATGTCAAGCCACT-1	Neural_Posterior
TTGATGTCACATGCTA-1	Neural_Posterior
TTGATGTCAGTACCGT-1	Neural_Posterior
TTGCAACAGGACCAGG-1	Neural_Posterior
TTGCAAGGTAATGACT-1	Neural_Anterior
TTGCAAGGTGTGTGGT-1	Neural_Anterior
TTGCAAGGTTGTAACG-1	Neural_Anterior
TTGCAAGGTTGTCCAT-1	Neural_Anterior
TTGCAATCATAATGTC-1	unassigned
TTGCACACAAATATCC-1	Neural_Posterior
TTGCACACACCCACCT-1	Neural_Anterior
TTGCACACACTAAGTT-1	Neural_Posterior
TTGCACACAGAATGAC-1	Somites
TTGCACACAGGAACAT-1	Neural_Anterior
TTGCACACAGTCTAAT-1	unassigned
TTGCACACATAACGGG-1	Neural_Anterior
TTGCACACATAAGTCT-1	Neural_Posterior
TTGCACACATGAGCAG-1	Neural_Posterior
TTGCAGCCAAGGTCGA-1	Muscle
TTGCAGCCACGTGCTG-1	Neural_Anterior
TTGCAGCCACTGGCCA-1	Neural_Anterior
TTGCAGCCATCCAGGT-1	Neural_Anterior
TTGCATTTCCAAGTGT-1	Neural_Anterior
TTGCATTTCCCGCCTA-1	Neural_Anterior
TTGCATTTCGCTAGAT-1	Neural_Anterior
TTGCATTTCGTCCTTA-1	Somites
TTGCATTTCTCAATGA-1	Neural_Anterior
TTGCATTTCTTTAGGA-1	Neural_Posterior
TTGCGAGTCATTTAGG-1	Neural_Posterior
TTGCGAGTCGATAACC-1	Neural_Anterior
TTGCGAGTCGCTCACT-1	Neural_Anterior
TTGCGTCTCCTGGTCT-1	Muscle
TTGCGTCTCCTTAAGA-1	Neural_Posterior
TTGCTCTCAAAGCGGC-1	Neural_Anterior
TTGCTTAGTTTGGCTT-1	Neural_Anterior
TTGCTTTAGAAGCTAG-1	Neural_Anterior
TTGCTTTAGGACACTT-1	Neural_Anterior
TTGCTTTAGTCAGGCC-1	Neural_Anterior
TTGCTTTAGTCCTTTG-1	Neural_Posterior
TTGCTTTAGTTACCGG-1	Neural_Posterior
TTGGAGGCAAGGATTA-1	Neural_Posterior
TTGGAGGCAAGTAAGC-1	Neural_Anterior
TTGGAGGCACATTGCA-1	Somites
TTGGAGGCACCGGTAT-1	Neural_Posterior
TTGGAGGCACTTCACT-1	Neural_Posterior
TTGGAGGCATGAAGTA-1	Neural_Anterior
TTGGATATCAGAAACG-1	Neural_Posterior
TTGGATATCCCTGTTA-1	Neural_Anterior
TTGGATATCGTACCGA-1	Neural_Posterior
TTGGATATCTGTGAGT-1	Neural_Posterior
TTGGATATCTTAGTGA-1	Neural_Anterior
TTGGATCAGAGAGGAG-1	Neural_Anterior
TTGGATCAGCAAACCT-1	Neural_Anterior
TTGGATCAGGCTACTG-1	Neural_Anterior
TTGGATCAGGGCTTTG-1	Neural_Anterior
TTGGATTCACAAGCCT-1	Neural_Posterior
TTGGATTCAGAAACGT-1	Neural_Anterior
TTGGATTCATCCTGAA-1	Neural_Anterior
TTGGCGGGTGCATCGG-1	Neural_Anterior
TTGGCTACAACTGGGA-1	Neural_Anterior
TTGGCTACACCTAATG-1	Neural_Anterior
TTGGCTGAGACAGGCG-1	Neural_Posterior
TTGGCTGAGTATCGCG-1	Somites
TTGGCTGAGTTACTTC-1	Neural_Posterior
TTGGCTTGTACCGGAT-1	Neural_Anterior
TTGGCTTGTGAGACTC-1	Neural_Anterior
TTGGCTTGTGTTAAAC-1	Neural_Posterior
TTGGCTTGTTAGAGCC-1	Neural_Anterior
TTGGCTTGTTCATCTA-1	Neural_Anterior
TTGGCTTGTTTCAGGA-1	Neural_Posterior
TTGGGCCAGCTGAGGG-1	Neural_Posterior
TTGGGCGGTAGTTGGC-1	Neural_Anterior
TTGGGCGGTTGGTTCT-1	Neural_Anterior
TTGGGCGGTTGGTTGA-1	Neural_Anterior
TTGGGTTAGCAAGGTA-1	Neural_Posterior
TTGGGTTAGGCTGTGC-1	Neural_Anterior
TTGGTGAGTGCTAGAC-1	Neural_Anterior
TTGTAAGTCCTCAGTC-1	Neural_Posterior
TTGTAAGTCGGTAACT-1	Neural_Anterior
TTGTAAGTCTGGCTTC-1	Neural_Anterior
TTGTCAAAGACTTATG-1	Somites
TTGTCAAAGGGTCTAT-1	Neural_Posterior
TTGTCCATCAGGATGA-1	Neural_Posterior
TTGTCCATCCTTGCGT-1	Neural_Posterior
TTGTCCATCTAATCCT-1	Neural_Anterior
TTGTCCGGTAGCCATA-1	Neural_Anterior
TTGTCCGGTATTGCAG-1	Neural_Anterior
TTGTCCGGTCACGAAC-1	Neural_Anterior
TTGTCCGGTCCGTGAG-1	Neural_Posterior
TTGTCCGGTGTGAGAG-1	Neural_Posterior
TTGTGAGGTACTTAGG-1	Neural_Posterior
TTGTGAGGTATCTGGA-1	Neural_Anterior
TTGTGAGGTCCGCTGT-1	Neural_Anterior
TTGTGAGGTGTTTGCT-1	Somites
TTGTGCCTCTTGAGGT-1	Neural_Posterior
TTGTGTGCATAGACTT-1	Neural_Posterior
TTGTGTGCATTTAAGC-1	Neural_Posterior
TTGTTCCCACGAATTT-1	Neural_Posterior
TTGTTGCGTCGCATAA-1	Neural_Anterior
TTGTTGTTCTGTGAGT-1	Neural_Posterior
TTGTTTGGTAATGGAA-1	Neural_Anterior
TTGTTTGGTGCAATGC-1	Neural_Anterior
TTGTTTGGTTCCGGCT-1	Neural_Posterior
TTTAACCTCAATTACG-1	Neural_Posterior
TTTAACCTCACAGACT-1	Neural_Posterior
TTTAACCTCCTGGCTT-1	Neural_Anterior
TTTAACGAGCGGATTT-1	Neural_Anterior
TTTAACGAGCTATGAC-1	Neural_Posterior
TTTAACGAGGAGTAAT-1	Neural_Anterior
TTTAACGAGGCGGATG-1	Neural_Anterior
TTTAAGCCAGCTTAGC-1	Neural_Posterior
TTTAAGCCATTAGGCC-1	Neural_Posterior
TTTAAGGTCCCTCATA-1	Neural_Anterior
TTTAAGGTCTAGCGTG-1	Neural_Posterior
TTTAAGGTCTTGCATT-1	Neural_Anterior
TTTACGAAGCTAGAAG-1	Neural_Anterior
TTTACGCGTTAGCCAA-1	Neural_Posterior
TTTACGCGTTCAAGAT-1	Neural_Posterior
TTTATGGAGGTGCGGA-1	Neural_Anterior
TTTATGGAGTGGACAA-1	Neural_Posterior
TTTATGGAGTTATCCT-1	Neural_Anterior
TTTCACCCAACAGGTG-1	Neural_Anterior
TTTCACCCAGCAATAA-1	Neural_Anterior
TTTCACCCATAACGGG-1	Neural_Anterior
TTTCAGTTCATAACCA-1	Neural_Anterior
TTTCAGTTCATCGTTT-1	Neural_Anterior
TTTCAGTTCATTAGGC-1	Neural_Posterior
TTTCATCAGTAGAGGC-1	Neural_Posterior
TTTCCACCAAACAACA-1	Neural_Posterior
TTTCCACCAATAGTCT-1	Neural_Anterior
TTTCCACCACTCGCTC-1	Neural_Posterior
TTTCCACCAGGATTAA-1	Neural_Anterior
TTTCCGGGTGTTTGCT-1	unassigned
TTTCCTGAGACTTACA-1	Neural_Anterior
TTTCCTGAGCACTAAC-1	Neural_Anterior
TTTCGTCCACTTCACT-1	Neural_Anterior
TTTCGTCCAGGACCAA-1	Neural_Anterior
TTTCGTCCATGGTTAT-1	Neural_Anterior
TTTGACCGTCACGGAT-1	Neural_Posterior
TTTGACCGTGAAACAA-1	Neural_Anterior
TTTGACCGTGCAATGC-1	Neural_Anterior
TTTGACCGTTAACGAT-1	Neural_Posterior
TTTGACTTCGTTAAGC-1	Neural_Posterior
TTTGAGTCAACCTGGT-1	Neural_Anterior
TTTGAGTCAGAGGGAG-1	Neural_Anterior
TTTGAGTCAGCCAGTT-1	Somites
TTTGAGTCATCCCGCT-1	Neural_Anterior
TTTGAGTCATGGCCTG-1	Neural_Anterior
TTTGCATTCAAGCGCC-1	Neural_Anterior
TTTGCATTCCGTTATT-1	Neural_Anterior
TTTGCATTCCTCCATA-1	Neural_Posterior
TTTGCGACAATATAGG-1	Neural_Posterior
TTTGCGACACCAAAGG-1	Neural_Posterior
TTTGCGACAGCTCATA-1	Neural_Anterior
TTTGCGACATCAGCAC-1	Neural_Anterior
TTTGCGGAGCCTGTTC-1	Neural_Anterior
TTTGCGGAGTCGCTAG-1	Neural_Anterior
TTTGCGGAGTGATTCA-1	Neural_Anterior
TTTGGCTGTAATCGGC-1	Neural_Posterior
TTTGGCTGTTAGGCGT-1	Neural_Anterior
TTTGGCTGTTATCCGT-1	Neural_Posterior
TTTGGTGCAAATTGCT-1	Neural_Anterior
TTTGGTGCAGGCAAGC-1	Neural_Posterior
TTTGTCCCATTAGGTT-1	Neural_Posterior
TTTGTCCCATTGTCCT-1	Neural_Posterior
TTTGTCTAGCGCAATT-1	Neural_Anterior
TTTGTCTAGGTAAGCA-1	Neural_Anterior
TTTGTCTAGTCTATGA-1	Neural_Anterior
TTTGTCTAGTTACCGG-1	Neural_Posterior
TTTGTGAAGAGCAAGC-1	Neural_Anterior
TTTGTGAAGCCGCAAC-1	Neural_Anterior
TTTGTGAAGGAGTAAT-1	Neural_Anterior
TTTGTGAAGGCGCTTA-1	Neural_Anterior
TTTGTGAAGGGTGAGT-1	Neural_Anterior
TTTGTGAAGTTCCCAC-1	Neural_Anterior
TTTGTGGCATAGCGGA-1	Muscle
TTTGTGTTCATCAGTA-1	Neural_Posterior
TTTGTGTTCTGTAATG-1	Neural_Posterior
